STATE,DISTRICT,BLOCK,70-90 mts,90-110 mts,110-130 mts,130-150 mts,GREATER THAN 150 mts,TOTAL
ANDAMAN & NICOBARS,ANDAMAN,FERRARGUNJ,2,0,0,0,0,2
ANDAMAN & NICOBARS,N & M ANDA,RANGAT,1,0,0,0,0,1
ANDHRA PRADESH,ADILABAD,ADILABAD,6,0,0,0,0,6
ANDHRA PRADESH,ADILABAD,ASIFABAD,7,0,0,0,0,7
ANDHRA PRADESH,ADILABAD,BAZARHATHNOOR,9,0,0,0,0,9
ANDHRA PRADESH,ADILABAD,BOATH,30,0,0,0,0,30
ANDHRA PRADESH,ADILABAD,CHENNUR,80,2,3,0,0,85
ANDHRA PRADESH,ADILABAD,DILAWARPUR,69,0,0,0,0,69
ANDHRA PRADESH,ADILABAD,ICHODA,292,0,0,0,0,292
ANDHRA PRADESH,ADILABAD,JAINAD,19,0,0,0,0,19
ANDHRA PRADESH,ADILABAD,KAGAZ NAGAR,25,0,0,0,0,25
ANDHRA PRADESH,ADILABAD,KASIPET,9,0,0,0,0,9
ANDHRA PRADESH,ADILABAD,KOTAPALLE,17,14,3,2,10,46
ANDHRA PRADESH,ADILABAD,LAXMANCHANDA,107,0,0,0,0,107
ANDHRA PRADESH,ADILABAD,MAMDA,38,0,0,0,0,38
ANDHRA PRADESH,ADILABAD,MANCHERIAL,1,0,0,0,0,1
ANDHRA PRADESH,ADILABAD,NERADIGONDA,80,0,0,0,0,80
ANDHRA PRADESH,ADILABAD,SARANGAPUR,3,0,0,0,0,3
ANDHRA PRADESH,ADILABAD,SIRPUR (T),1,0,0,0,0,1
ANDHRA PRADESH,ADILABAD,SIRPUR (U),1,0,0,0,0,1
ANDHRA PRADESH,ADILABAD,TIRYANI,14,0,0,0,0,14
ANDHRA PRADESH,ADILABAD,VEMANPALLE,1,0,0,0,0,1
ANDHRA PRADESH,ANANTHAPUR,AGALI,111,301,122,91,224,849
ANDHRA PRADESH,ANANTHAPUR,AMADAGUR,240,350,160,67,35,852
ANDHRA PRADESH,ANANTHAPUR,AMARAPURAM,10,0,8,0,65,83
ANDHRA PRADESH,ANANTHAPUR,ANANTAPUR,38,0,0,0,0,38
ANDHRA PRADESH,ANANTHAPUR,BATHALAPALLE,44,6,0,0,0,50
ANDHRA PRADESH,ANANTHAPUR,BELUGUPPA,24,0,0,0,0,24
ANDHRA PRADESH,ANANTHAPUR,BRAHMASAMUDRAM,43,0,0,0,0,43
ANDHRA PRADESH,ANANTHAPUR,BUKKAPATNAM,69,20,4,0,0,93
ANDHRA PRADESH,ANANTHAPUR,BUKKARAYASAMUDRAM,67,1,0,0,0,68
ANDHRA PRADESH,ANANTHAPUR,CHENNE KOTHAPALLE,309,14,0,0,0,323
ANDHRA PRADESH,ANANTHAPUR,CHILAMATHUR,77,151,65,9,19,321
ANDHRA PRADESH,ANANTHAPUR,D.HIRCHAL,1597,3,0,0,0,1600
ANDHRA PRADESH,ANANTHAPUR,DHARMAVARAM,176,34,4,1,0,215
ANDHRA PRADESH,ANANTHAPUR,GARLADINNE,40,56,41,0,1,138
ANDHRA PRADESH,ANANTHAPUR,GORANTLA,112,1,0,0,0,113
ANDHRA PRADESH,ANANTHAPUR,GUDIBANDA,37,76,35,37,133,318
ANDHRA PRADESH,ANANTHAPUR,GUMMAGATTA,1310,29,0,0,0,1339
ANDHRA PRADESH,ANANTHAPUR,GUNTAKAL,66,0,0,0,0,66
ANDHRA PRADESH,ANANTHAPUR,HINDUPUR,246,0,0,0,0,246
ANDHRA PRADESH,ANANTHAPUR,KADIRI,173,113,1,0,0,287
ANDHRA PRADESH,ANANTHAPUR,KALYANDURG,117,6,0,0,0,123
ANDHRA PRADESH,ANANTHAPUR,KAMBADUR,203,99,4,0,0,306
ANDHRA PRADESH,ANANTHAPUR,KANAGANAPALLE,238,0,0,0,0,238
ANDHRA PRADESH,ANANTHAPUR,KANEKAL,60,0,0,0,0,60
ANDHRA PRADESH,ANANTHAPUR,KOTHACHERUVU,136,15,1,0,0,152
ANDHRA PRADESH,ANANTHAPUR,KUNDURPI,172,67,0,0,0,239
ANDHRA PRADESH,ANANTHAPUR,LEPAKSHI,96,85,0,0,0,181
ANDHRA PRADESH,ANANTHAPUR,MADAKASIRA,0,113,162,71,131,477
ANDHRA PRADESH,ANANTHAPUR,MUDIGUBBA,3,5,4,0,0,12
ANDHRA PRADESH,ANANTHAPUR,NALLAMADA,3,0,0,0,0,3
ANDHRA PRADESH,ANANTHAPUR,PARIGI,9,41,53,17,572,692
ANDHRA PRADESH,ANANTHAPUR,PEDDAPAPPUR,124,0,0,0,0,124
ANDHRA PRADESH,ANANTHAPUR,PEDDAVADUGUR,166,55,0,0,0,221
ANDHRA PRADESH,ANANTHAPUR,PENU KONDA,67,25,1,2,0,95
ANDHRA PRADESH,ANANTHAPUR,PUTLUR,1532,495,190,2,6,2225
ANDHRA PRADESH,ANANTHAPUR,PUTTAPARTHI,262,187,26,0,0,475
ANDHRA PRADESH,ANANTHAPUR,RAMAGIRI,308,26,2,0,0,336
ANDHRA PRADESH,ANANTHAPUR,RAYADURG,753,42,0,0,0,795
ANDHRA PRADESH,ANANTHAPUR,RODDAM,714,216,46,0,1,977
ANDHRA PRADESH,ANANTHAPUR,ROLLA,31,53,214,132,224,654
ANDHRA PRADESH,ANANTHAPUR,SINGANAMALA,231,190,12,1,2,436
ANDHRA PRADESH,ANANTHAPUR,SOMANDEPALLE,354,297,133,27,11,822
ANDHRA PRADESH,ANANTHAPUR,TADIMARRI,291,13,0,0,0,304
ANDHRA PRADESH,ANANTHAPUR,TALUPULA,503,6,0,0,0,509
ANDHRA PRADESH,ANANTHAPUR,TANAKAL,433,218,9,1,1,662
ANDHRA PRADESH,ANANTHAPUR,YADIKI,1432,123,24,6,2,1587
ANDHRA PRADESH,CHITTOOR,B KOTHAKOTA,131,417,350,181,89,1168
ANDHRA PRADESH,CHITTOOR,BAIREDDI PALLE,580,374,383,167,39,1543
ANDHRA PRADESH,CHITTOOR,BANGARUPALEM,16,298,1055,90,23,1482
ANDHRA PRADESH,CHITTOOR,BUCHINAIDU KHANDRIGA,177,2,0,0,0,179
ANDHRA PRADESH,CHITTOOR,CHANDRAGIRI,794,102,16,4,0,916
ANDHRA PRADESH,CHITTOOR,CHINNAGOTTIGALLU,1054,0,1,0,0,1055
ANDHRA PRADESH,CHITTOOR,CHITTOOR,665,2,2,0,21,690
ANDHRA PRADESH,CHITTOOR,CHOWDEPALLE,476,335,224,279,35,1349
ANDHRA PRADESH,CHITTOOR,GANGADHARA NELLORE,950,481,161,126,93,1811
ANDHRA PRADESH,CHITTOOR,GANGAVARAM,671,904,370,81,35,2061
ANDHRA PRADESH,CHITTOOR,GUDI PALLE,0,602,674,0,0,1276
ANDHRA PRADESH,CHITTOOR,GUDIPALA,44,247,316,256,157,1020
ANDHRA PRADESH,CHITTOOR,GURRAMKONDA,1162,197,9,1,1,1370
ANDHRA PRADESH,CHITTOOR,IRALA,1010,184,19,13,0,1226
ANDHRA PRADESH,CHITTOOR,K V P PURAM,423,274,2,0,0,699
ANDHRA PRADESH,CHITTOOR,KALAKADA,208,349,91,15,3,666
ANDHRA PRADESH,CHITTOOR,KALIKIRI,693,129,74,39,29,964
ANDHRA PRADESH,CHITTOOR,KAMBHAMVARIPALLE,887,0,0,0,0,887
ANDHRA PRADESH,CHITTOOR,KARVETINAGAR,377,893,275,1,2,1548
ANDHRA PRADESH,CHITTOOR,KUPPAM,0,569,1353,0,0,1922
ANDHRA PRADESH,CHITTOOR,KURABALAKOTA,15,481,619,249,32,1396
ANDHRA PRADESH,CHITTOOR,MANDANPALLE,117,867,878,388,105,2355
ANDHRA PRADESH,CHITTOOR,MULAKALACHERUVU,89,386,464,107,31,1077
ANDHRA PRADESH,CHITTOOR,NAGALAPURAM,26,0,0,0,0,26
ANDHRA PRADESH,CHITTOOR,NAGARI,17,0,0,0,0,17
ANDHRA PRADESH,CHITTOOR,NIMMANAPALLE,327,475,402,146,114,1464
ANDHRA PRADESH,CHITTOOR,PAKALA,84,383,495,196,132,1290
ANDHRA PRADESH,CHITTOOR,PALAMANER,856,370,208,113,62,1609
ANDHRA PRADESH,CHITTOOR,PALASAMUDRAM,154,155,5,0,0,314
ANDHRA PRADESH,CHITTOOR,PEDDA PANJANI,948,530,527,53,5,2063
ANDHRA PRADESH,CHITTOOR,PEDDAMANDYAM,492,41,9,1,0,543
ANDHRA PRADESH,CHITTOOR,PEDDATHIPPASAMUDRAM,1838,0,0,0,0,1838
ANDHRA PRADESH,CHITTOOR,PENUMURU,958,393,153,27,3,1534
ANDHRA PRADESH,CHITTOOR,PICHATUR,222,147,1,0,0,370
ANDHRA PRADESH,CHITTOOR,PILERU,218,458,168,93,79,1016
ANDHRA PRADESH,CHITTOOR,PULICHERLA,816,240,94,15,3,1168
ANDHRA PRADESH,CHITTOOR,PUNGANUR,185,1052,768,231,81,2317
ANDHRA PRADESH,CHITTOOR,PUTHALAPATTU,77,248,239,386,960,1910
ANDHRA PRADESH,CHITTOOR,PUTTUR,54,10,0,0,0,64
ANDHRA PRADESH,CHITTOOR,RAMA KUPPAM,177,340,826,145,79,1567
ANDHRA PRADESH,CHITTOOR,RAMACHANDRAPURAM,1144,0,0,0,0,1144
ANDHRA PRADESH,CHITTOOR,RAMASAMUDRAM,225,321,494,339,821,2200
ANDHRA PRADESH,CHITTOOR,ROMPICHERLA,302,324,192,130,51,999
ANDHRA PRADESH,CHITTOOR,SANTHI PURAM,1417,250,104,210,124,2105
ANDHRA PRADESH,CHITTOOR,SATYAVEDU,1,0,0,0,0,1
ANDHRA PRADESH,CHITTOOR,SODAM,21,0,0,0,1209,1230
ANDHRA PRADESH,CHITTOOR,SOMALA,1101,83,110,142,173,1609
ANDHRA PRADESH,CHITTOOR,SRIKALAHASTI,290,7,0,0,0,297
ANDHRA PRADESH,CHITTOOR,SRIRANGARAJAPURAM,295,1329,20,0,0,1644
ANDHRA PRADESH,CHITTOOR,THAMBALLAPALLE,629,86,1,0,0,716
ANDHRA PRADESH,CHITTOOR,THAVANAMPALLE,1510,476,29,0,0,2015
ANDHRA PRADESH,CHITTOOR,THOTTAMBEDU,42,3,0,0,0,45
ANDHRA PRADESH,CHITTOOR,TIRUPATI RURAL,199,133,64,4,3,403
ANDHRA PRADESH,CHITTOOR,TIRUPATI URBAN,0,0,4,0,0,4
ANDHRA PRADESH,CHITTOOR,VADAMALAPETA,252,331,60,0,1,644
ANDHRA PRADESH,CHITTOOR,VAYALPAD,175,471,383,287,130,1446
ANDHRA PRADESH,CHITTOOR,VEDURU KUPPAM,115,721,379,62,0,1277
ANDHRA PRADESH,CHITTOOR,VENKATAGIRI KOTA,71,284,936,319,332,1942
ANDHRA PRADESH,CHITTOOR,YADAMARI,76,398,470,112,12,1068
ANDHRA PRADESH,CHITTOOR,YERRAVARIPALEM,26,703,133,16,3,881
ANDHRA PRADESH,CUDDAPAH,A.KASINAYANI,1,1178,3,0,0,1182
ANDHRA PRADESH,CUDDAPAH,ATLUR,546,349,0,0,0,895
ANDHRA PRADESH,CUDDAPAH,B KODUR,141,854,28,0,0,1023
ANDHRA PRADESH,CUDDAPAH,BADVEL,489,176,24,3,0,692
ANDHRA PRADESH,CUDDAPAH,BRAHMAMGARIMATTAM,62,1279,24,0,0,1365
ANDHRA PRADESH,CUDDAPAH,CHAKRAYAPET,70,188,2,0,0,260
ANDHRA PRADESH,CUDDAPAH,CHAPAD,184,17,2,0,0,203
ANDHRA PRADESH,CUDDAPAH,CHENNUR,32,58,55,19,9,173
ANDHRA PRADESH,CUDDAPAH,CHINNAMANDEM,6,120,277,71,13,487
ANDHRA PRADESH,CUDDAPAH,CHINTHA KOMMADINNE,175,930,0,0,0,1105
ANDHRA PRADESH,CUDDAPAH,CHITVEL,1141,0,0,0,2,1143
ANDHRA PRADESH,CUDDAPAH,CUDDAPAH,128,48,28,2,0,206
ANDHRA PRADESH,CUDDAPAH,DUVVUR,741,112,20,23,75,971
ANDHRA PRADESH,CUDDAPAH,GALIVEEDU,14,260,154,51,10,489
ANDHRA PRADESH,CUDDAPAH,GOPAVARAM,2,289,1,0,0,292
ANDHRA PRADESH,CUDDAPAH,JAMMALAMADUGU,209,3,0,0,0,212
ANDHRA PRADESH,CUDDAPAH,KALASAPADU,685,624,0,0,0,1309
ANDHRA PRADESH,CUDDAPAH,KAMALAPURAM,79,55,17,14,0,165
ANDHRA PRADESH,CUDDAPAH,KHAJIPET,1258,49,5,1,0,1313
ANDHRA PRADESH,CUDDAPAH,KODUR,676,0,0,0,0,676
ANDHRA PRADESH,CUDDAPAH,KONDAPURAM,9,0,0,0,0,9
ANDHRA PRADESH,CUDDAPAH,LAKKIREDDIPALLE,39,59,0,0,0,98
ANDHRA PRADESH,CUDDAPAH,LINGALA,130,524,255,116,108,1133
ANDHRA PRADESH,CUDDAPAH,MUDDANUR,760,193,42,20,45,1060
ANDHRA PRADESH,CUDDAPAH,MYLAVARAM,75,41,48,12,0,176
ANDHRA PRADESH,CUDDAPAH,NANDALUR,138,192,24,21,3,378
ANDHRA PRADESH,CUDDAPAH,OBULAVARIPALLE,616,828,34,1,0,1479
ANDHRA PRADESH,CUDDAPAH,PEDDAMUDIUM,231,210,73,1,0,515
ANDHRA PRADESH,CUDDAPAH,PENAGALURU,835,0,0,0,1,836
ANDHRA PRADESH,CUDDAPAH,PENDLIMARRI,358,538,495,347,353,2091
ANDHRA PRADESH,CUDDAPAH,PORUMAMILLA,22,1558,6,0,0,1586
ANDHRA PRADESH,CUDDAPAH,PULIVENDLA,262,335,211,65,204,1077
ANDHRA PRADESH,CUDDAPAH,PULLAMPETA,180,486,633,240,192,1731
ANDHRA PRADESH,CUDDAPAH,RAJAMPET,1444,394,1,0,0,1839
ANDHRA PRADESH,CUDDAPAH,RAMAPURAM,270,104,30,3,2,409
ANDHRA PRADESH,CUDDAPAH,RAYACHOTI,118,90,3,1,6,218
ANDHRA PRADESH,CUDDAPAH,S MYDUKUR,208,606,454,419,217,1904
ANDHRA PRADESH,CUDDAPAH,SAMBEPALLE,294,171,72,5,1,543
ANDHRA PRADESH,CUDDAPAH,SIDHOUT,113,113,85,14,12,337
ANDHRA PRADESH,CUDDAPAH,SIMHADRIPURAM,109,566,217,94,111,1097
ANDHRA PRADESH,CUDDAPAH,T SUNDUPALLE,154,40,30,0,0,224
ANDHRA PRADESH,CUDDAPAH,THANDUR,175,400,131,48,52,806
ANDHRA PRADESH,CUDDAPAH,VALLUR,78,57,2,0,0,137
ANDHRA PRADESH,CUDDAPAH,VEERABALLE,387,0,0,0,0,387
ANDHRA PRADESH,CUDDAPAH,VEERAPUNAYUNIPALLE,3,1,19,10,0,33
ANDHRA PRADESH,CUDDAPAH,VEMPALLE,114,30,39,14,0,197
ANDHRA PRADESH,CUDDAPAH,VEMULA,271,599,0,0,0,870
ANDHRA PRADESH,CUDDAPAH,VONTIMITTA,703,184,2,0,0,889
ANDHRA PRADESH,CUDDAPAH,YERRAGUNTLA,204,37,3,0,0,244
ANDHRA PRADESH,EAST GODAVARI,ALAMURU,175,0,0,0,0,175
ANDHRA PRADESH,EAST GODAVARI,AMALAPURAM,55,0,0,0,0,55
ANDHRA PRADESH,EAST GODAVARI,ANAPARTHI,93,0,0,0,0,93
ANDHRA PRADESH,EAST GODAVARI,BICCAVOLU,329,5,4,1,0,339
ANDHRA PRADESH,EAST GODAVARI,GANDEPALLE,188,470,190,129,0,977
ANDHRA PRADESH,EAST GODAVARI,GOLLAPROLU,97,16,45,10,17,185
ANDHRA PRADESH,EAST GODAVARI,JAGGAMPETA,1,2,0,0,0,3
ANDHRA PRADESH,EAST GODAVARI,KIRLAMPUDI,67,0,0,0,0,67
ANDHRA PRADESH,EAST GODAVARI,KORUKONDA,43,522,0,0,0,565
ANDHRA PRADESH,EAST GODAVARI,KOTANANDURU,6,0,0,0,0,6
ANDHRA PRADESH,EAST GODAVARI,PEDDAPURAM,207,57,22,0,0,286
ANDHRA PRADESH,EAST GODAVARI,PITHAPURAM,469,0,0,0,0,469
ANDHRA PRADESH,EAST GODAVARI,PRATHIPADU,73,2,0,0,0,75
ANDHRA PRADESH,EAST GODAVARI,RAJAHMUNDRY(RURAL),28,14,0,0,0,42
ANDHRA PRADESH,EAST GODAVARI,RAJANAGARAM,236,401,605,66,14,1322
ANDHRA PRADESH,EAST GODAVARI,RANGAMPETA,458,29,37,27,34,585
ANDHRA PRADESH,EAST GODAVARI,ROWTHULAPUDI,127,0,0,0,0,127
ANDHRA PRADESH,EAST GODAVARI,SAMALKOTA,52,74,4,0,1,131
ANDHRA PRADESH,EAST GODAVARI,SANKHAVARAM,6,0,0,0,28,34
ANDHRA PRADESH,EAST GODAVARI,SEETHANAGARAM,492,0,0,0,0,492
ANDHRA PRADESH,EAST GODAVARI,THONDANGI,65,49,20,5,5,144
ANDHRA PRADESH,EAST GODAVARI,TUNI,44,0,0,0,0,44
ANDHRA PRADESH,GUNTUR,DURGI,482,663,568,12,3,1728
ANDHRA PRADESH,GUNTUR,KAREMPUDI,902,29,0,0,1,932
ANDHRA PRADESH,GUNTUR,MACHAVARAM,318,0,0,0,0,318
ANDHRA PRADESH,GUNTUR,MACHERLA,750,376,155,5,10,1296
ANDHRA PRADESH,GUNTUR,PEDAKURAPADU,7,0,0,0,0,7
ANDHRA PRADESH,GUNTUR,PIDUGURALLA,437,0,0,0,0,437
ANDHRA PRADESH,GUNTUR,TADIKONDA,380,0,0,0,0,380
ANDHRA PRADESH,GUNTUR,VELDURTHI,820,362,56,0,5,1243
ANDHRA PRADESH,KARIMNAGAR,BEJJANKI,46,47,93,0,0,186
ANDHRA PRADESH,KARIMNAGAR,CHOPPADANDI,2,0,0,0,0,2
ANDHRA PRADESH,KARIMNAGAR,ELLANTHAKUNTA,2,0,0,0,0,2
ANDHRA PRADESH,KARIMNAGAR,GAMBHIRAOPET,27,0,0,0,0,27
ANDHRA PRADESH,KARIMNAGAR,KAMANPUR,9,0,0,0,2,11
ANDHRA PRADESH,KARIMNAGAR,KATHLAPUR,3312,0,0,0,2,3314
ANDHRA PRADESH,KARIMNAGAR,KESAVAPATNAM,2,0,0,0,0,2
ANDHRA PRADESH,KARIMNAGAR,MAHADEVPUR,1071,0,0,0,1,1072
ANDHRA PRADESH,KARIMNAGAR,MALHARRAO,712,0,0,0,0,712
ANDHRA PRADESH,KARIMNAGAR,MALLIAL,6,0,0,0,0,6
ANDHRA PRADESH,KARIMNAGAR,METPALLE,700,0,0,0,4,704
ANDHRA PRADESH,KARIMNAGAR,MUSTABAD,217,0,0,0,0,217
ANDHRA PRADESH,KARIMNAGAR,MUTHARAM MAHADEVPUR,120,0,0,0,0,120
ANDHRA PRADESH,KARIMNAGAR,SIRSILLA,2,0,0,0,0,2
ANDHRA PRADESH,KARIMNAGAR,YELLA REDDI PETA,650,0,1,0,0,651
ANDHRA PRADESH,KHAMMAM,ASWAPURAM,1,0,0,0,0,1
ANDHRA PRADESH,KHAMMAM,ASWARAOPETA,169,7,2,0,0,178
ANDHRA PRADESH,KHAMMAM,BAYYARAM,9,0,0,0,0,9
ANDHRA PRADESH,KHAMMAM,CHANDRUGONDA,90,1,0,0,0,91
ANDHRA PRADESH,KHAMMAM,CHERLA,3,0,0,0,0,3
ANDHRA PRADESH,KHAMMAM,DAMMAPETA,267,354,15,0,9,645
ANDHRA PRADESH,KHAMMAM,ENKURU,475,1,0,0,0,476
ANDHRA PRADESH,KHAMMAM,JULURPAD,75,0,0,0,0,75
ANDHRA PRADESH,KHAMMAM,KALLURU,8,0,0,0,0,8
ANDHRA PRADESH,KHAMMAM,KHAMMAM URBAN,1,0,0,0,0,1
ANDHRA PRADESH,KHAMMAM,KONIJERLA,207,0,0,0,0,207
ANDHRA PRADESH,KHAMMAM,KOTHAGUDEM,116,0,0,0,0,116
ANDHRA PRADESH,KHAMMAM,MUDIGONDA,11,0,0,0,0,11
ANDHRA PRADESH,KHAMMAM,PINAPAKA,0,0,0,0,1,1
ANDHRA PRADESH,KHAMMAM,SATHUPALLE,366,574,389,224,58,1611
ANDHRA PRADESH,KHAMMAM,TEKULAPALLE,2,0,0,0,0,2
ANDHRA PRADESH,KHAMMAM,VEMSOOR,210,49,1,0,0,260
ANDHRA PRADESH,KRISHNA,AGIRIPALLE,13,0,0,0,0,13
ANDHRA PRADESH,KRISHNA,BAPULAPADU,426,531,398,79,7,1441
ANDHRA PRADESH,KRISHNA,CHATRAI,1704,22,0,0,5,1731
ANDHRA PRADESH,KRISHNA,G KONDURU,49,0,0,0,0,49
ANDHRA PRADESH,KRISHNA,MUSUNURU,1107,618,235,128,390,2478
ANDHRA PRADESH,KRISHNA,NUZVID,8,485,1107,69,19,1688
ANDHRA PRADESH,KRISHNA,PENUGANCHIPROLU,3,0,0,0,0,3
ANDHRA PRADESH,KRISHNA,UNGUTURU,1,0,0,0,0,1
ANDHRA PRADESH,KRISHNA,VATSAVAI,6,0,0,0,0,6
ANDHRA PRADESH,KRISHNA,VISSANNAPET,985,3,0,0,0,988
ANDHRA PRADESH,KURNOOL,ADONI,5,42,22,6,5,80
ANDHRA PRADESH,KURNOOL,ALLAGADDA,693,93,0,0,0,786
ANDHRA PRADESH,KURNOOL,ALUR,1,0,0,0,0,1
ANDHRA PRADESH,KURNOOL,ASPARI,393,0,0,0,0,393
ANDHRA PRADESH,KURNOOL,ATMAKUR,34,0,0,0,0,34
ANDHRA PRADESH,KURNOOL,BETHAMCHERLA,1,0,0,0,0,1
ANDHRA PRADESH,KURNOOL,CHAGALAMARRI,1380,0,0,0,0,1380
ANDHRA PRADESH,KURNOOL,CHIPPAGIRI,1,0,0,0,0,1
ANDHRA PRADESH,KURNOOL,DEVANAKONDA,9,0,0,0,0,9
ANDHRA PRADESH,KURNOOL,GONEGANDLA,654,9,0,0,0,663
ANDHRA PRADESH,KURNOOL,KODUMUR,326,0,0,0,0,326
ANDHRA PRADESH,KURNOOL,KOILKUNTLA,2,0,0,0,0,2
ANDHRA PRADESH,KURNOOL,KOWTHALAM,6,0,0,0,0,6
ANDHRA PRADESH,KURNOOL,KURNOOL,262,0,0,0,0,262
ANDHRA PRADESH,KURNOOL,MAHANANDI,1,0,0,0,0,1
ANDHRA PRADESH,KURNOOL,MANTRALAYAM,3,0,0,0,0,3
ANDHRA PRADESH,KURNOOL,NANDI KOTKUR,102,3,0,0,0,105
ANDHRA PRADESH,KURNOOL,ORVAKAL,418,0,0,0,0,418
ANDHRA PRADESH,KURNOOL,PATTIKANDA,116,0,0,0,0,116
ANDHRA PRADESH,KURNOOL,PEDDA KADUBUR,8,0,0,0,0,8
ANDHRA PRADESH,KURNOOL,RUDRAVARAM,201,108,0,0,1,310
ANDHRA PRADESH,MAHABOOBNAGAR,ADDAKAL,266,0,0,0,0,266
ANDHRA PRADESH,MAHABOOBNAGAR,AMANGAL,21,0,0,0,0,21
ANDHRA PRADESH,MAHABOOBNAGAR,AMRABAD,2,0,0,0,0,2
ANDHRA PRADESH,MAHABOOBNAGAR,BHOOTHPUR,60,8,0,0,0,68
ANDHRA PRADESH,MAHABOOBNAGAR,BIJINAPALLE,2,0,0,0,0,2
ANDHRA PRADESH,MAHABOOBNAGAR,BOMRASPETA,1,0,0,0,0,1
ANDHRA PRADESH,MAHABOOBNAGAR,DAMARAGIDDA,86,0,0,0,0,86
ANDHRA PRADESH,MAHABOOBNAGAR,DHANWADA,7,0,0,0,0,7
ANDHRA PRADESH,MAHABOOBNAGAR,DHARUR,1,0,0,0,0,1
ANDHRA PRADESH,MAHABOOBNAGAR,GHANPUR,24,0,0,0,0,24
ANDHRA PRADESH,MAHABOOBNAGAR,HANWADA,17,0,0,0,0,17
ANDHRA PRADESH,MAHABOOBNAGAR,JADCHERLA,362,5,1,1,0,369
ANDHRA PRADESH,MAHABOOBNAGAR,KALWAKURTHY,580,13,0,0,2,595
ANDHRA PRADESH,MAHABOOBNAGAR,KESHAMPETA,726,16,0,0,0,742
ANDHRA PRADESH,MAHABOOBNAGAR,KODAIR,24,0,0,0,0,24
ANDHRA PRADESH,MAHABOOBNAGAR,KOILKONDA,3127,67,4,0,0,3198
ANDHRA PRADESH,MAHABOOBNAGAR,KOLLAPUR,18,0,0,0,0,18
ANDHRA PRADESH,MAHABOOBNAGAR,KONDURG,1,0,0,0,0,1
ANDHRA PRADESH,MAHABOOBNAGAR,KOSGI,5,0,0,0,0,5
ANDHRA PRADESH,MAHABOOBNAGAR,MADDUR,12,0,0,0,0,12
ANDHRA PRADESH,MAHABOOBNAGAR,MADGUL,364,0,0,0,0,364
ANDHRA PRADESH,MAHABOOBNAGAR,MAHBUBNAGAR,2199,151,1,0,5,2356
ANDHRA PRADESH,MAHABOOBNAGAR,MALDAKAL,1,0,0,0,0,1
ANDHRA PRADESH,MAHABOOBNAGAR,MIDJIL,528,0,0,0,13,541
ANDHRA PRADESH,MAHABOOBNAGAR,NAGAR KURNOOL,1978,0,0,0,0,1978
ANDHRA PRADESH,MAHABOOBNAGAR,NARAYANPET,27,0,0,0,0,27
ANDHRA PRADESH,MAHABOOBNAGAR,NARVA,8,0,0,0,0,8
ANDHRA PRADESH,MAHABOOBNAGAR,TADOOR,3,0,0,0,0,3
ANDHRA PRADESH,MAHABOOBNAGAR,TELKAPALLE,276,3,0,0,1,280
ANDHRA PRADESH,MAHABOOBNAGAR,THIMMAJIPETA,18,0,0,0,0,18
ANDHRA PRADESH,MAHABOOBNAGAR,UPPUNUNTHALA,7,0,0,0,0,7
ANDHRA PRADESH,MAHABOOBNAGAR,UTKOOR,4,0,0,0,0,4
ANDHRA PRADESH,MAHABOOBNAGAR,VANGOOR,1166,0,0,0,0,1166
ANDHRA PRADESH,MAHABOOBNAGAR,VELDANDA,1636,0,1,0,9,1646
ANDHRA PRADESH,MAHABOOBNAGAR,WANAPARTHY,1,0,0,0,0,1
ANDHRA PRADESH,MEDAK,CHEGUNTA,1493,63,2,0,0,1558
ANDHRA PRADESH,MEDAK,CHINNA KODUR,917,302,39,2,0,1260
ANDHRA PRADESH,MEDAK,DUBBAK,903,552,2,0,0,1457
ANDHRA PRADESH,MEDAK,HATHNOORA,667,52,3,1,7,730
ANDHRA PRADESH,MEDAK,KALHER,414,0,0,0,0,414
ANDHRA PRADESH,MEDAK,KANGTI,6,0,0,0,0,6
ANDHRA PRADESH,MEDAK,KOHIR,146,360,167,0,0,673
ANDHRA PRADESH,MEDAK,KONDAPAK,3417,242,0,0,0,3659
ANDHRA PRADESH,MEDAK,KONDAPUR,1388,4,0,0,0,1392
ANDHRA PRADESH,MEDAK,KOWDIPALLE,1399,288,1,0,0,1688
ANDHRA PRADESH,MEDAK,MIRDODDI,4030,505,0,0,0,4535
ANDHRA PRADESH,MEDAK,MULUG,2,1,0,0,0,3
ANDHRA PRADESH,MEDAK,MUNPALLE,767,0,0,0,0,767
ANDHRA PRADESH,MEDAK,NANGANUR,40,7,0,0,1,48
ANDHRA PRADESH,MEDAK,NARAYANKHED,0,10,0,0,0,10
ANDHRA PRADESH,MEDAK,NARSAPUR,11,0,0,0,0,11
ANDHRA PRADESH,MEDAK,NYALKAL,362,10,0,0,0,372
ANDHRA PRADESH,MEDAK,PATANCHERU,262,20,0,0,0,282
ANDHRA PRADESH,MEDAK,RAMAYAMPET,1101,21,0,0,0,1122
ANDHRA PRADESH,MEDAK,SADASIVPET,99,0,0,0,0,99
ANDHRA PRADESH,MEDAK,SANGAREDDY,257,58,1,0,0,316
ANDHRA PRADESH,MEDAK,SHANKARAMPET (R),384,0,0,0,0,384
ANDHRA PRADESH,MEDAK,SIDDIPET,476,56,0,0,0,532
ANDHRA PRADESH,MEDAK,TEKMAL,692,0,0,0,0,692
ANDHRA PRADESH,MEDAK,THOGUTA,0,56,56,17,0,129
ANDHRA PRADESH,MEDAK,YELDURTHY,22,3,0,0,0,25
ANDHRA PRADESH,MEDAK,ZAHIRABAD,1018,876,66,0,0,1960
ANDHRA PRADESH,NALGONDA,ALAIR,53,0,0,0,0,53
ANDHRA PRADESH,NALGONDA,ANUMULA,110,0,0,0,0,110
ANDHRA PRADESH,NALGONDA,CHANDAM PET,98,0,0,0,0,98
ANDHRA PRADESH,NALGONDA,CHANDUR,12,0,0,0,0,12
ANDHRA PRADESH,NALGONDA,CHINTHA PALLE,75,0,0,0,0,75
ANDHRA PRADESH,NALGONDA,CHITYALA,666,45,2,0,0,713
ANDHRA PRADESH,NALGONDA,CHOUTUPPAL,32,0,0,0,0,32
ANDHRA PRADESH,NALGONDA,DAMERACHERLA,39,0,0,0,0,39
ANDHRA PRADESH,NALGONDA,GURRAMPODE,3,0,0,0,0,3
ANDHRA PRADESH,NALGONDA,KANGAL,1,1,0,0,0,2
ANDHRA PRADESH,NALGONDA,KATTANGOOR,1,0,0,0,0,1
ANDHRA PRADESH,NALGONDA,KETHEPALLE,239,0,0,0,1,240
ANDHRA PRADESH,NALGONDA,M TURKAPALLE,3,0,0,0,0,3
ANDHRA PRADESH,NALGONDA,MIRYALAGUDA,30,0,0,0,0,30
ANDHRA PRADESH,NALGONDA,MOTHKUR,154,0,0,0,0,154
ANDHRA PRADESH,NALGONDA,NAKREKAL,8,9,0,0,0,17
ANDHRA PRADESH,NALGONDA,NARAYANAPUR,1,0,0,0,0,1
ANDHRA PRADESH,NALGONDA,RAJAPET,1,0,0,0,0,1
ANDHRA PRADESH,NALGONDA,SALIGOURARAM,4,0,0,0,0,4
ANDHRA PRADESH,NALGONDA,THIPPARTHI,1,0,0,0,0,1
ANDHRA PRADESH,NALGONDA,THRIPURARAM,5,0,0,0,0,5
ANDHRA PRADESH,NALGONDA,THUNGA THURTHI,27,0,0,0,0,27
ANDHRA PRADESH,NALGONDA,YADAGIRIGUTTA,2,1,0,0,0,3
ANDHRA PRADESH,NELLORE,ANANTHASAGARAM,83,0,0,0,0,83
ANDHRA PRADESH,NELLORE,ANUMASAMUDRAMPETA,603,2,1,0,0,606
ANDHRA PRADESH,NELLORE,BALAYAPALLE,1,6,5,0,0,12
ANDHRA PRADESH,NELLORE,CHEJERLA,2,0,0,0,0,2
ANDHRA PRADESH,NELLORE,CHILLAKUR,15,1,0,0,0,16
ANDHRA PRADESH,NELLORE,GUDUR,27,0,0,0,0,27
ANDHRA PRADESH,NELLORE,INDUKURPET,188,0,0,0,0,188
ANDHRA PRADESH,NELLORE,KALUVOYA,4,0,0,0,0,4
ANDHRA PRADESH,NELLORE,MANUBOLU,7,0,0,0,0,7
ANDHRA PRADESH,NELLORE,OJILI,32,0,0,0,0,32
ANDHRA PRADESH,NELLORE,PELLAKUR,22,0,0,0,0,22
ANDHRA PRADESH,NELLORE,PODLAKUR,1,0,0,0,0,1
ANDHRA PRADESH,NELLORE,THOTAPALLIGUDUR,313,0,0,0,1,314
ANDHRA PRADESH,NIZAMABAD,MACHAREDDY,1,0,0,0,0,1
ANDHRA PRADESH,NIZAMABAD,NIZAMABAD,1,0,0,0,0,1
ANDHRA PRADESH,PRAKASAM,ADDANKI,14,0,0,0,0,14
ANDHRA PRADESH,PRAKASAM,ARDHAVEEDU,2094,256,29,0,1,2380
ANDHRA PRADESH,PRAKASAM,BALLIKURUVA,1,0,0,0,0,1
ANDHRA PRADESH,PRAKASAM,BESTAVARIPETA,23,2318,16,0,0,2357
ANDHRA PRADESH,PRAKASAM,CHADRASEKARAPURAM,1,0,0,0,0,1
ANDHRA PRADESH,PRAKASAM,CHIMAKURTHI,45,0,0,0,0,45
ANDHRA PRADESH,PRAKASAM,CUMBUM,1190,41,0,0,1,1232
ANDHRA PRADESH,PRAKASAM,DONAKONDA,10,0,0,0,0,10
ANDHRA PRADESH,PRAKASAM,DORNALA,1364,688,28,0,0,2080
ANDHRA PRADESH,PRAKASAM,GIDDALURU,1880,669,29,0,5,2583
ANDHRA PRADESH,PRAKASAM,GUDLURU,74,0,0,0,2,76
ANDHRA PRADESH,PRAKASAM,HANUMANTHUNIPADU,49,0,0,0,2,51
ANDHRA PRADESH,PRAKASAM,JANAKAVARAMPANGULURU,15,0,0,0,0,15
ANDHRA PRADESH,PRAKASAM,KANIGIRI,227,0,0,0,0,227
ANDHRA PRADESH,PRAKASAM,KOMAROLU,43,1555,55,1,1,1655
ANDHRA PRADESH,PRAKASAM,KOTHAPATNAM,2,0,0,0,0,2
ANDHRA PRADESH,PRAKASAM,LINGASAMUDRAM,5,0,0,0,0,5
ANDHRA PRADESH,PRAKASAM,MARKAPUR,2085,423,301,0,0,2809
ANDHRA PRADESH,PRAKASAM,MARTUR,203,0,0,0,1,204
ANDHRA PRADESH,PRAKASAM,MUNDLAMURU,1,0,0,0,0,1
ANDHRA PRADESH,PRAKASAM,PAMUR,1,0,0,0,0,1
ANDHRA PRADESH,PRAKASAM,PEDAARAVEEDU,1861,994,96,0,0,2951
ANDHRA PRADESH,PRAKASAM,PODILI,2,0,0,0,0,2
ANDHRA PRADESH,PRAKASAM,PULLALACHERUVU,1597,1629,4,0,0,3230
ANDHRA PRADESH,PRAKASAM,RACHERLA,2134,93,0,0,3,2230
ANDHRA PRADESH,PRAKASAM,TARLAPADU,1239,592,14,0,1,1846
ANDHRA PRADESH,PRAKASAM,THALLUR,2,0,0,0,0,2
ANDHRA PRADESH,PRAKASAM,TRIPURANTHAKAM,1154,584,34,0,0,1772
ANDHRA PRADESH,PRAKASAM,ULAVAPADU,1,0,0,0,0,1
ANDHRA PRADESH,PRAKASAM,VELIGANDLA,83,3,0,0,0,86
ANDHRA PRADESH,PRAKASAM,YERRAGONDAPALEM,1732,2249,14,0,8,4003
ANDHRA PRADESH,RANGAREDDY,CHEVELLA,68,0,0,0,0,68
ANDHRA PRADESH,RANGAREDDY,GANDEED,1,0,0,0,0,1
ANDHRA PRADESH,RANGAREDDY,IBRAHIMPATAM,821,0,0,0,0,821
ANDHRA PRADESH,RANGAREDDY,MEDCHAL,665,115,0,0,8,788
ANDHRA PRADESH,RANGAREDDY,MOINABAD,11,0,0,0,0,11
ANDHRA PRADESH,RANGAREDDY,SHABAD,53,0,0,0,0,53
ANDHRA PRADESH,RANGAREDDY,SHAMIRPET,266,0,0,0,0,266
ANDHRA PRADESH,RANGAREDDY,TANDUR,22,0,0,0,0,22
ANDHRA PRADESH,RANGAREDDY,YACHARAM,182,0,0,0,0,182
ANDHRA PRADESH,SRIKAKULAM,ETCHERLA,7,9,0,0,0,16
ANDHRA PRADESH,SRIKAKULAM,GARA,15,0,0,0,0,15
ANDHRA PRADESH,SRIKAKULAM,RAJAM,1,0,0,0,0,1
ANDHRA PRADESH,SRIKAKULAM,RANASTALAM,50,17,0,0,0,67
ANDHRA PRADESH,VISAKHAPATNAM,BUTCHAYYAPETA,23,0,0,0,0,23
ANDHRA PRADESH,VISAKHAPATNAM,DUMBRIGUDA,1,0,0,0,0,1
ANDHRA PRADESH,VISAKHAPATNAM,KOTAURATLA,1,0,0,0,0,1
ANDHRA PRADESH,VISAKHAPATNAM,NAKKAPALLI,17,0,0,0,0,17
ANDHRA PRADESH,VISAKHAPATNAM,NARSIPATNAM,5,0,0,0,0,5
ANDHRA PRADESH,VISAKHAPATNAM,NATHAVARAM,2,0,0,0,0,2
ANDHRA PRADESH,VISAKHAPATNAM,PAYAKARAOPETA,9,0,0,0,0,9
ANDHRA PRADESH,VISAKHAPATNAM,PENDURTHI,5,0,0,0,0,5
ANDHRA PRADESH,VISAKHAPATNAM,ROLUGUNTA,1,0,0,0,0,1
ANDHRA PRADESH,VISAKHAPATNAM,S RAYAVARAM,1,0,0,0,0,1
ANDHRA PRADESH,VISAKHAPATNAM,YELAMANCHILI,3,0,0,0,0,3
ANDHRA PRADESH,VIZIANAGARAM,BALAJIPETA,7,0,0,0,0,7
ANDHRA PRADESH,VIZIANAGARAM,BHOGHAPURAM,1,0,0,0,0,1
ANDHRA PRADESH,VIZIANAGARAM,MENTADA,1,0,0,0,0,1
ANDHRA PRADESH,VIZIANAGARAM,PACHIPENTA,2,0,0,0,0,2
ANDHRA PRADESH,VIZIANAGARAM,PUSAPATIREGA,1,0,0,0,0,1
ANDHRA PRADESH,VIZIANAGARAM,SEETHANAGARAM,8,0,0,0,0,8
ANDHRA PRADESH,VIZIANAGARAM,THERLAM,11,0,0,0,0,11
ANDHRA PRADESH,WARANGAL,BACHANNAPETA,1,0,0,0,0,1
ANDHRA PRADESH,WARANGAL,BHUPALPALLE,117,0,0,0,0,117
ANDHRA PRADESH,WARANGAL,CHERIYAL,1929,0,4,0,0,1933
ANDHRA PRADESH,WARANGAL,GHANAPUR,5,0,0,0,0,5
ANDHRA PRADESH,WARANGAL,HANAMKONDA,53,2,0,0,0,55
ANDHRA PRADESH,WARANGAL,JANGAON,33,0,0,0,0,33
ANDHRA PRADESH,WARANGAL,KESAMUDRAM,1,0,0,0,0,1
ANDHRA PRADESH,WARANGAL,KOTHAGUDEM,4,0,0,0,0,4
ANDHRA PRADESH,WARANGAL,NARMETTA,1,0,0,0,0,1
ANDHRA PRADESH,WARANGAL,NARSIMHULAPET,104,0,0,0,0,104
ANDHRA PRADESH,WARANGAL,RAGHUNATHA PALLE,91,0,0,0,0,91
ANDHRA PRADESH,WARANGAL,RAIPARTHY,122,0,0,0,0,122
ANDHRA PRADESH,WARANGAL,SANGEM,15,0,0,0,0,15
ANDHRA PRADESH,WARANGAL,SHAYAMPET,234,0,0,0,0,234
ANDHRA PRADESH,WARANGAL,THORRUR,1,0,0,0,0,1
ANDHRA PRADESH,WARANGAL,VENKATAPUR,918,113,3,0,0,1034
ANDHRA PRADESH,WEST GODAVARI,BHIMADOLE,3,119,0,0,8,130
ANDHRA PRADESH,WEST GODAVARI,BUTTAYAGUDEM,795,9,0,0,0,804
ANDHRA PRADESH,WEST GODAVARI,CHAGALLU,522,0,0,0,0,522
ANDHRA PRADESH,WEST GODAVARI,CHINTALAPUDI,2393,0,0,0,1,2394
ANDHRA PRADESH,WEST GODAVARI,DENDULURU,1,15,1207,5,12,1240
ANDHRA PRADESH,WEST GODAVARI,DEVARAPALLE,2262,2,0,0,7,2271
ANDHRA PRADESH,WEST GODAVARI,DWARAKA TIRUMALA,10,2649,7,0,1,2667
ANDHRA PRADESH,WEST GODAVARI,ELURU,0,2,0,0,0,2
ANDHRA PRADESH,WEST GODAVARI,GOPALAPURAM,804,178,99,157,14,1252
ANDHRA PRADESH,WEST GODAVARI,JANGAREDDIGUDEM,1984,0,0,0,0,1984
ANDHRA PRADESH,WEST GODAVARI,JEELUGUMILLI,353,2,0,0,2,357
ANDHRA PRADESH,WEST GODAVARI,KAMAVARAPUKOTA,0,2365,0,0,0,2365
ANDHRA PRADESH,WEST GODAVARI,KOVVUR,20,0,0,0,0,20
ANDHRA PRADESH,WEST GODAVARI,KOYYALAGUDEM,754,21,42,14,2,833
ANDHRA PRADESH,WEST GODAVARI,LINGAPALEM,1170,845,0,0,0,2015
ANDHRA PRADESH,WEST GODAVARI,NALLAJERLA,2153,2,0,0,5,2160
ANDHRA PRADESH,WEST GODAVARI,NIDADAVOLE,979,59,0,0,0,1038
ANDHRA PRADESH,WEST GODAVARI,PEDAPADU,3,38,156,191,70,458
ANDHRA PRADESH,WEST GODAVARI,PEDAVEGI,1737,1417,20,0,0,3174
ANDHRA PRADESH,WEST GODAVARI,PENTAPADU,9,0,0,0,0,9
ANDHRA PRADESH,WEST GODAVARI,PERAVALI,308,0,0,0,0,308
ANDHRA PRADESH,WEST GODAVARI,T NARASAPURAM,0,3778,0,0,4,3782
ANDHRA PRADESH,WEST GODAVARI,TADEPALLIGUDEM,0,2690,0,0,0,2690
ANDHRA PRADESH,WEST GODAVARI,THALLAPUDI,82,3,0,0,0,85
ANDHRA PRADESH,WEST GODAVARI,UNGUTURU,0,1322,0,0,0,1322
ARUNACHAL PRADESH,CHANGLANG,BORDUMSA-DIYUN,2,0,0,0,0,2
ARUNACHAL PRADESH,DIBANG VALLEY,ROING-DAMBUK,5,0,0,0,0,5
ARUNACHAL PRADESH,LOHIT,NAMSAI-CHOWKHAM,1,0,0,0,0,1
ARUNACHAL PRADESH,TIRAP,NIAUSA,3,0,0,0,0,3
ASSAM,BAKSA,BASKA,3,3,0,0,0,6
ASSAM,BAKSA,DHAMDHAMA DEV BLOCK,2,0,0,0,0,2
ASSAM,BAKSA,NAGRIJULI DEV BLOCK,1,0,0,0,0,1
ASSAM,BAKSA,TAMULPUR DEV BLOCK,1,0,0,0,0,1
ASSAM,BAKSA,TIHU - BARAMA,3,0,0,0,0,3
ASSAM,BARPETA,BARPETA,3,0,0,0,0,3
ASSAM,BARPETA,CHENGA,7,0,0,0,0,7
ASSAM,BARPETA,JALAH,1,0,0,0,0,1
ASSAM,BARPETA,SARUKHETRI,7,0,0,0,0,7
ASSAM,BONGAIGAON,BAITAMARI,9,0,0,0,0,9
ASSAM,BONGAIGAON,DANGTOL,0,0,17,0,0,17
ASSAM,BONGAIGAON,SRIJANGRAM,1,0,0,0,0,1
ASSAM,BONGAIGAON,TAPATTARY,1,5,1,0,0,7
ASSAM,CACHAR,BASKANDI,0,0,0,0,1,1
ASSAM,CACHAR,PALANGHAT,0,0,1,0,0,1
ASSAM,CACHAR,SILCHAR,1,0,0,0,0,1
ASSAM,CACHAR,SONAI,1,0,2,1,0,4
ASSAM,CACHAR,UDARBAND,0,1,0,0,0,1
ASSAM,CHIRANG,BORO BAZAR DEV .BLOC,2,0,0,0,0,2
ASSAM,CHIRANG,SIDLI CHIRANG DEV .B,1,5,0,0,0,6
ASSAM,DARRANG,DALGAON SIALMARI,4,4,2,0,0,10
ASSAM,DARRANG,KALAIGAON,2,0,0,0,0,2
ASSAM,DARRANG,PACHIM MANGALDOI,1,0,0,0,3,4
ASSAM,DARRANG,PUB MANGALDOI,1,24,0,0,0,25
ASSAM,DARRANG,SIPAJHAR,0,20,1,0,0,21
ASSAM,DHEMAJI,DHEMAJI,4,6,0,0,0,10
ASSAM,DHEMAJI,SISSIBOR GAON,6,0,0,1,0,7
ASSAM,DHUBRI,AGAMONI,6,0,0,0,0,6
ASSAM,DHUBRI,CHAPAR SALKOCHA D.B.,4,0,0,0,0,4
ASSAM,DHUBRI,DEBITOLA,1,0,0,0,0,1
ASSAM,DHUBRI,FEKAMARI,14,0,0,0,0,14
ASSAM,DHUBRI,GAURIPUR,2,0,0,0,0,2
ASSAM,DHUBRI,GOLOKGANJ,1,6,0,0,0,7
ASSAM,DHUBRI,MAHAMAYA,1,0,0,0,0,1
ASSAM,DHUBRI,MANKACHAR,14,0,0,0,0,14
ASSAM,DIBRUGARH,BARBARUA,1,0,3,0,0,4
ASSAM,DIBRUGARH,JOYPUR,3,2,0,0,0,5
ASSAM,DIBRUGARH,KHOWANG,1,0,0,5,0,6
ASSAM,DIBRUGARH,LAHOWAL,12,0,0,1,1,14
ASSAM,DIBRUGARH,PANITOLA,3,0,0,0,0,3
ASSAM,DIBRUGARH,TENGAKHAT,25,0,0,0,0,25
ASSAM,DIBRUGARH,TINGKHONG,3,0,0,0,0,3
ASSAM,GOALPARA,BALIJAN,9,0,0,0,0,9
ASSAM,GOALPARA,JALESWAR,4,0,0,0,0,4
ASSAM,GOALPARA,KHARMUJA,2,7,0,1,0,10
ASSAM,GOALPARA,KRISHNAI,6,0,0,0,0,6
ASSAM,GOALPARA,KUSHDHAWA,2,0,0,0,0,2
ASSAM,GOALPARA,LAKHIPUR,2,0,0,0,0,2
ASSAM,GOALPARA,MATIA,11,0,0,0,0,11
ASSAM,GOALPARA,RANGJULI,6,2,0,0,0,8
ASSAM,GOLAGHAT,GOLAGHAT CENTRAL,11,0,0,0,0,11
ASSAM,GOLAGHAT,GOLAGHAT EAST,3,0,0,0,0,3
ASSAM,GOLAGHAT,GOLAGHAT NORTH,8,0,0,0,0,8
ASSAM,GOLAGHAT,GOLAGHAT SOUTH,1,3,18,0,0,22
ASSAM,GOLAGHAT,KAKODONGA,22,2,1,0,0,25
ASSAM,GOLAGHAT,MORONGI,1,0,0,0,0,1
ASSAM,HAILAKANDI,ALGAPUR,7,1,0,0,0,8
ASSAM,HAILAKANDI,HAILAKANDI,1,0,0,0,0,1
ASSAM,HAILAKANDI,LALA,0,0,3,0,0,3
ASSAM,JORHAT,JORHAT,9,0,14,1,0,24
ASSAM,JORHAT,JORHAT CENTRAL,2,37,0,0,2,41
ASSAM,JORHAT,JORHAT NORTH WEST,16,7,0,0,0,23
ASSAM,JORHAT,KALIAPANI,8,2,6,0,0,16
ASSAM,JORHAT,MAJULI,2,0,0,0,0,2
ASSAM,JORHAT,TITABAR,3,0,0,0,0,3
ASSAM,JORHAT,UJANI MAJULI,18,5,0,0,0,23
ASSAM,KAMRUP ( RURAL ),BOKO,5,0,0,0,0,5
ASSAM,KAMRUP ( RURAL ),CHAMARIA,1,0,0,0,0,1
ASSAM,KAMRUP ( RURAL ),CHAYGAON DEV BLOCK,2,0,0,0,0,2
ASSAM,KAMRUP ( RURAL ),GAROIMARI DEVELOPMEN,3,0,0,0,0,3
ASSAM,KAMRUP ( RURAL ),HAJO,5,0,0,0,0,5
ASSAM,KAMRUP ( RURAL ),KAMALPUR DEVELOPMENT,1,0,0,0,8,9
ASSAM,KAMRUP ( RURAL ),RANGIA DEVELOPMENT B,3,0,0,0,0,3
ASSAM,KAMRUP ( RURAL ),SAULKUCHI,15,0,0,0,0,15
ASSAM,KAMRUP METRO,CHANDRAPUR,1,0,0,0,0,1
ASSAM,KAMRUP METRO,RANI,1,0,0,0,0,1
ASSAM,KARBIANGLONG,HOWRAGHAT,1,0,5,0,0,6
ASSAM,KARBIANGLONG,LONGSOMEPI,0,1,0,0,0,1
ASSAM,KARBIANGLONG,RONGKHAG,0,1,1,0,0,2
ASSAM,KARIMGANJ,BADARPUR,0,0,0,0,4,4
ASSAM,KARIMGANJ,NORTH KARIMGANJ,0,0,0,0,1,1
ASSAM,KARIMGANJ,PATHERKANDI,0,0,0,0,1,1
ASSAM,KARIMGANJ,SOUTH KARIMGANJ,0,0,0,0,6,6
ASSAM,KOKRAJHAR,DOTOMA,2,0,0,0,0,2
ASSAM,KOKRAJHAR,GOSSAIGAON,6,0,0,0,0,6
ASSAM,KOKRAJHAR,KACHUGAON,3,0,0,0,0,3
ASSAM,KOKRAJHAR,KOKRAJHAR,6,2,0,0,0,8
ASSAM,LAKHIMPUR,BIHPURIA,1,3,1,1,0,6
ASSAM,LAKHIMPUR,BOGINODI,4,4,0,0,0,8
ASSAM,LAKHIMPUR,DHAKUAKHANA,6,1,0,0,0,7
ASSAM,LAKHIMPUR,GHILAMARI,0,1,0,0,0,1
ASSAM,LAKHIMPUR,KARUNABARI,0,20,2,0,0,22
ASSAM,LAKHIMPUR,LAKHIMPUR,8,1,0,0,0,9
ASSAM,LAKHIMPUR,NARAYANPUR,4,25,0,0,0,29
ASSAM,LAKHIMPUR,NOWBOICHA,5,6,4,0,0,15
ASSAM,LAKHIMPUR,TELAHI,2,3,0,0,0,5
ASSAM,MORIGAON,BHUR- BANDHA,11,0,0,0,0,11
ASSAM,MORIGAON,LAHORIGHAT,2,0,4,0,0,6
ASSAM,MORIGAON,MAIRABARI,2,0,2,0,0,4
ASSAM,MORIGAON,MAYONG,1,0,0,0,0,1
ASSAM,NAGOAN,BAJIAGAON,2,0,0,0,0,2
ASSAM,NAGOAN,BARHAMPUR,6,0,0,0,0,6
ASSAM,NAGOAN,BINNAKANDI,11,0,0,0,0,11
ASSAM,NAGOAN,DHALPUKHURI,1,0,0,0,0,1
ASSAM,NAGOAN,KALIABOR,4,3,0,0,0,7
ASSAM,NAGOAN,KATHIATOLI,7,0,0,0,0,7
ASSAM,NAGOAN,KHAGARIJAN,0,1,0,0,0,1
ASSAM,NAGOAN,PACHIM KALIABOR,2,0,0,0,0,2
ASSAM,NAGOAN,RAHA,1,0,0,0,0,1
ASSAM,NAGOAN,RUPAHI,1,0,0,0,0,1
ASSAM,NAGOAN,UDALI,1,4,1,2,0,8
ASSAM,NALBARI,BARKHETRI,11,0,0,0,0,11
ASSAM,NALBARI,BORIGOG BONBHAG,0,6,4,0,0,10
ASSAM,NALBARI,MADHUPUR DEV. BLOCK,3,0,0,0,0,3
ASSAM,NALBARI,PASCHIM NALBARI,22,0,0,0,0,22
ASSAM,NALBARI,PUB NALBARI,2,13,0,0,0,15
ASSAM,NALBARI,TIHU,3,0,0,0,0,3
ASSAM,SIBSAGAR,AMGURI,0,0,1,0,0,1
ASSAM,SIBSAGAR,DEMOW,2,0,0,0,0,2
ASSAM,SIBSAGAR,GOURISAGAR,0,5,0,0,2,7
ASSAM,SIBSAGAR,NAZIRA,1,0,0,0,1,2
ASSAM,SIBSAGAR,PACHIM ABHOYPUR,0,0,1,0,0,1
ASSAM,SIBSAGAR,SEPEKHATI,0,0,0,3,0,3
ASSAM,SIBSAGAR,SIBSAGAR,1,0,15,0,0,16
ASSAM,SIBSAGAR,SONARI,1,0,0,0,0,1
ASSAM,SONITPUR,BAGHMARA,8,0,0,0,0,8
ASSAM,SONITPUR,BALIPARA,5,0,0,0,0,5
ASSAM,SONITPUR,BEHELI,65,0,0,0,0,65
ASSAM,SONITPUR,BIHAGURI,1,0,0,0,0,1
ASSAM,SONITPUR,BISHWANATH,1,0,0,0,0,1
ASSAM,SONITPUR,BORCHALA,8,0,0,0,0,8
ASSAM,SONITPUR,CHAIDUAR,2,0,0,0,0,2
ASSAM,SONITPUR,CHATIA,2,0,0,0,0,2
ASSAM,SONITPUR,DHEKIAJULI,8,0,0,0,0,8
ASSAM,SONITPUR,GABHARU,1,0,0,0,0,1
ASSAM,SONITPUR,PUB-CHAIDUAR,3,0,0,0,0,3
ASSAM,SONITPUR,SOKAMATHA,12,0,0,0,0,12
ASSAM,TINSUKIA,GUIJAN,7,0,0,2,1,10
ASSAM,TINSUKIA,HAPJAN,1,0,2,11,0,14
ASSAM,TINSUKIA,KAKAPATHAR,7,0,10,0,0,17
ASSAM,TINSUKIA,MARGHERITA,1,0,6,1,0,8
ASSAM,TINSUKIA,SAIKHOWA,18,2,3,0,0,23
ASSAM,UDALGURI,2 NO MAZBAT,1,0,0,0,0,1
ASSAM,UDALGURI,BHERGAON,11,2,0,0,0,13
ASSAM,UDALGURI,UDALGURI,22,0,0,0,0,22
BIHAR,ARARIA,ARARIA,16,0,0,0,0,16
BIHAR,ARARIA,BHARGAMA,1,0,0,0,0,1
BIHAR,ARARIA,FORBESGANJ,2,0,0,0,0,2
BIHAR,ARARIA,KURSAKANTA,22,0,0,0,0,22
BIHAR,ARARIA,SIKTI,1,0,0,0,0,1
BIHAR,AURANGABAD,BARUN,175,1,0,0,0,176
BIHAR,AURANGABAD,DAUDNAGAR,3,0,0,0,0,3
BIHAR,AURANGABAD,DEO,11,0,0,0,0,11
BIHAR,AURANGABAD,GOH,45,0,0,0,0,45
BIHAR,AURANGABAD,HASPURA,8,0,0,0,0,8
BIHAR,AURANGABAD,KUTUMBA,179,0,0,0,0,179
BIHAR,AURANGABAD,MADANPUR,71,0,0,0,0,71
BIHAR,AURANGABAD,NABINAGAR,192,0,0,0,0,192
BIHAR,AURANGABAD,OBRA,85,0,0,0,0,85
BIHAR,AURANGABAD,RAFIGANAJ,328,0,0,0,0,328
BIHAR,BANKA,AMARPUR,4,0,0,0,0,4
BIHAR,BANKA,BANKA,1,0,0,0,0,1
BIHAR,BANKA,DHORAIYA,1,0,0,0,0,1
BIHAR,BANKA,KATORIYA,16,0,0,0,0,16
BIHAR,BANKA,PHULLIDUMER,1,0,0,0,0,1
BIHAR,BANKA,SAMBHUGANJ,6,0,1,0,0,7
BIHAR,BEGUSARAI,BACHHAWARA,211,0,0,0,0,211
BIHAR,BEGUSARAI,BAKHRI,23,0,0,0,0,23
BIHAR,BEGUSARAI,BALLIA,47,0,0,0,0,47
BIHAR,BEGUSARAI,BARAUNI,330,0,0,0,0,330
BIHAR,BEGUSARAI,BEGUSARAI,308,2,0,0,0,310
BIHAR,BEGUSARAI,BHAGWANPUR,80,1,0,0,0,81
BIHAR,BEGUSARAI,BIRPUR,159,0,0,0,0,159
BIHAR,BEGUSARAI,CHHAURAHI,20,1,0,0,0,21
BIHAR,BEGUSARAI,DANDARI,4,0,0,0,0,4
BIHAR,BEGUSARAI,GADHPURA,244,0,0,0,0,244
BIHAR,BEGUSARAI,MANSOORCHAK,246,0,0,0,0,246
BIHAR,BEGUSARAI,MATIHANI,98,0,0,0,0,98
BIHAR,BEGUSARAI,NAWAKOTHI,72,0,0,0,0,72
BIHAR,BEGUSARAI,S.KAMAL,22,0,0,0,0,22
BIHAR,BEGUSARAI,SAMHO AKHA KURHA,69,0,0,0,0,69
BIHAR,BEGUSARAI,TEGHRA,68,1,0,0,0,69
BIHAR,BHAGALPUR,BIHPUR,0,3,0,0,0,3
BIHAR,BHAGALPUR,GOPALPUR,0,4,0,0,0,4
BIHAR,BHAGALPUR,GOURADIH,0,5,0,0,0,5
BIHAR,BHAGALPUR,JAGDISHPUR,0,1,0,0,0,1
BIHAR,BHAGALPUR,KAHALGAON,1,0,0,0,0,1
BIHAR,BHAGALPUR,KHARIK,1,4,0,0,0,5
BIHAR,BHAGALPUR,PIRPAINTY,0,2,0,0,0,2
BIHAR,BHAGALPUR,SABOUR,0,3,0,0,0,3
BIHAR,BHAGALPUR,SHAHKUND,2,0,0,0,0,2
BIHAR,BHAGALPUR,SULTANGANJ,0,1,0,0,0,1
BIHAR,BHOJPUR,AGIAON,0,13,0,0,0,13
BIHAR,BHOJPUR,ARA,1,45,1,0,0,47
BIHAR,BHOJPUR,BARHARA,0,44,2,0,0,46
BIHAR,BHOJPUR,BEHEA,0,41,0,0,0,41
BIHAR,BHOJPUR,CHARPOKHARI,0,9,0,0,0,9
BIHAR,BHOJPUR,JAGDISHPUR,0,185,0,0,0,185
BIHAR,BHOJPUR,KOILWAR,0,47,0,0,0,47
BIHAR,BHOJPUR,PIRO,0,7,0,0,0,7
BIHAR,BHOJPUR,SAHAR,0,7,0,0,0,7
BIHAR,BHOJPUR,SANDESH,0,2,0,0,0,2
BIHAR,BHOJPUR,SHAHPUR,0,124,0,0,0,124
BIHAR,BHOJPUR,TARARI,1,2,0,0,1,4
BIHAR,BHOJPUR,UDWANTNAGAR,0,21,0,0,0,21
BIHAR,BUXAR,BRAHMPUR,29,0,0,0,0,29
BIHAR,BUXAR,BUXAR,237,5,0,0,3,245
BIHAR,BUXAR,CHOUGAI,3,0,0,0,0,3
BIHAR,BUXAR,CHOUSA,7,0,0,0,0,7
BIHAR,BUXAR,DUMRAON,45,0,0,0,0,45
BIHAR,BUXAR,ITARHI,18,0,0,0,0,18
BIHAR,BUXAR,KESATH,1,0,0,0,0,1
BIHAR,BUXAR,NAWANAGAR,171,0,0,0,0,171
BIHAR,BUXAR,RAJPUR,11,0,0,0,0,11
BIHAR,BUXAR,SIMRI,27,0,0,0,0,27
BIHAR,DARBHANGA,BAHADURPUR,3,0,1,0,0,4
BIHAR,DARBHANGA,BENIPUR,1,0,0,0,0,1
BIHAR,DARBHANGA,BIRAUL,1,0,0,0,0,1
BIHAR,DARBHANGA,DARBHANGA,75,0,0,0,0,75
BIHAR,DARBHANGA,GAURA BAURAM,1,0,0,0,0,1
BIHAR,DARBHANGA,HAYAGHAT,1,0,0,0,0,1
BIHAR,DARBHANGA,JALE,1,0,0,0,0,1
BIHAR,DARBHANGA,KEOTI RUNWAY,1,0,0,0,0,1
BIHAR,DARBHANGA,KUSESHWAR ASTHAN,1,0,0,0,0,1
BIHAR,DARBHANGA,MANIGACHHI,3,0,0,0,0,3
BIHAR,DARBHANGA,SINGHWARA,1,0,0,0,0,1
BIHAR,DARBHANGA,TARDIH,1,0,0,0,0,1
BIHAR,EAST CHAMPARAN,BANJARIYA,3,0,0,0,0,3
BIHAR,EAST CHAMPARAN,CHAKIYA,8,0,0,0,0,8
BIHAR,EAST CHAMPARAN,CHAURADANO,0,1,0,0,0,1
BIHAR,EAST CHAMPARAN,CHIRIYA,3,0,0,0,0,3
BIHAR,EAST CHAMPARAN,DHAKA,190,1,0,0,0,191
BIHAR,EAST CHAMPARAN,GHORASAHAN,19,0,0,0,0,19
BIHAR,EAST CHAMPARAN,KALYANPUR,1,0,0,1,0,2
BIHAR,EAST CHAMPARAN,KESARIA,9,0,0,1,0,10
BIHAR,EAST CHAMPARAN,MADHUBAN,2,0,0,0,0,2
BIHAR,EAST CHAMPARAN,MOTIHARI,23,0,0,0,0,23
BIHAR,EAST CHAMPARAN,PAHARPUR,1,0,0,0,0,1
BIHAR,EAST CHAMPARAN,PAKRIDYAL,7,1,0,0,0,8
BIHAR,EAST CHAMPARAN,PATAHI,1,0,0,0,0,1
BIHAR,EAST CHAMPARAN,PHENHARA,20,0,0,0,0,20
BIHAR,EAST CHAMPARAN,PIPRAKOTHI,11,0,0,0,0,11
BIHAR,EAST CHAMPARAN,RAXAUL,1,0,0,0,0,1
BIHAR,EAST CHAMPARAN,TETARIA,2,0,0,0,0,2
BIHAR,EAST CHAMPARAN,TURKAULIA,4,0,0,0,0,4
BIHAR,GAYA,AMAS,2,0,0,0,0,2
BIHAR,GAYA,ATRI,4,0,0,0,0,4
BIHAR,GAYA,BANKE BAZAR,14,0,0,0,0,14
BIHAR,GAYA,BARACHATTY,3,0,0,0,0,3
BIHAR,GAYA,BELAGANJ,17,0,0,0,0,17
BIHAR,GAYA,BODHGAYA,12,0,0,0,2,14
BIHAR,GAYA,DOBHI,5,0,0,0,0,5
BIHAR,GAYA,DUMARIYA,6,0,0,0,0,6
BIHAR,GAYA,FATEHPUR,11,0,0,0,0,11
BIHAR,GAYA,GAYA NAGAR,3,0,0,0,0,3
BIHAR,GAYA,GURARU,9,0,0,0,0,9
BIHAR,GAYA,GURUA,3,0,0,0,0,3
BIHAR,GAYA,IMAMGANJ,2,0,0,0,0,2
BIHAR,GAYA,KHIZARSARAI,6,0,0,0,1,7
BIHAR,GAYA,KONCH,30,0,0,0,0,30
BIHAR,GAYA,MANPUR,130,0,0,0,0,130
BIHAR,GAYA,MOHANPUR,4,0,0,0,0,4
BIHAR,GAYA,MOHARA,2,0,0,0,0,2
BIHAR,GAYA,PARAIYA,4,0,0,0,0,4
BIHAR,GAYA,SHERGHATTY,62,16,0,0,0,78
BIHAR,GAYA,TANKUPPA,1,0,0,0,0,1
BIHAR,GAYA,TEKARI,17,0,1,0,0,18
BIHAR,GAYA,WAZIRGANJ,2,0,0,0,0,2
BIHAR,GOPAALGANJ,BAIKUNTHPUR,24,0,0,0,0,24
BIHAR,GOPAALGANJ,BARAULI,132,0,0,0,0,132
BIHAR,GOPAALGANJ,BHOREY,17,0,0,0,0,17
BIHAR,GOPAALGANJ,BIJAIPUR,15,0,0,0,0,15
BIHAR,GOPAALGANJ,GOPALGANJ,10,1,0,0,0,11
BIHAR,GOPAALGANJ,HATHUA,13,0,0,0,0,13
BIHAR,GOPAALGANJ,KATEYA,7,0,0,0,0,7
BIHAR,GOPAALGANJ,KUCHAIKOTE,59,5,0,0,0,64
BIHAR,GOPAALGANJ,MANJHA,5,0,0,0,0,5
BIHAR,GOPAALGANJ,PANCHDEWRI,1,0,0,0,0,1
BIHAR,GOPAALGANJ,PHULWARIYA,75,0,0,0,0,75
BIHAR,GOPAALGANJ,SIDHWALIYA,3,0,0,0,0,3
BIHAR,GOPAALGANJ,THAWE,7,0,0,0,0,7
BIHAR,GOPAALGANJ,UCHKAGAON,2,0,0,0,0,2
BIHAR,JAMUI,ALIGANJ,17,0,0,0,0,17
BIHAR,JAMUI,BARHAT,1,0,0,0,0,1
BIHAR,JAMUI,CHAKAI,48,0,0,0,0,48
BIHAR,JAMUI,JAMUI,142,0,0,0,0,142
BIHAR,JAMUI,JHAJHA,27,0,0,0,0,27
BIHAR,JAMUI,KHAIRA,95,0,0,0,0,95
BIHAR,JAMUI,LAXMIPUR,9,0,0,0,0,9
BIHAR,JAMUI,SIKANDARA,236,0,0,0,0,236
BIHAR,JAMUI,SONO,1,0,0,0,0,1
BIHAR,JEHANABAD,ARWAL,66,28,0,0,0,94
BIHAR,JEHANABAD,GHOSHI,0,440,0,0,0,440
BIHAR,JEHANABAD,HULASGANJ,2,0,0,0,0,2
BIHAR,JEHANABAD,JEHANABAD,2,0,0,0,0,2
BIHAR,JEHANABAD,KAKO,13,22,0,0,0,35
BIHAR,JEHANABAD,KALER,3,3,0,0,0,6
BIHAR,JEHANABAD,KARPI,17,5,0,0,0,22
BIHAR,JEHANABAD,KURTHA,4,0,0,0,0,4
BIHAR,JEHANABAD,MAKHDUMPUR,1,0,0,0,0,1
BIHAR,JEHANABAD,MODANGANJ,1,0,0,0,0,1
BIHAR,KAIMUR (BHABUA),BHABUA,13,7,0,0,0,20
BIHAR,KAIMUR (BHABUA),BHAGWANPUR,2,0,0,0,0,2
BIHAR,KAIMUR (BHABUA),CHAINPUR,163,0,0,0,0,163
BIHAR,KAIMUR (BHABUA),CHAND,5,0,0,0,0,5
BIHAR,KAIMUR (BHABUA),DURGAWATI,12,0,0,0,0,12
BIHAR,KAIMUR (BHABUA),KUDRA,71,4,2,0,0,77
BIHAR,KAIMUR (BHABUA),MOHANIA,47,0,0,0,0,47
BIHAR,KAIMUR (BHABUA),NUAON,21,0,0,0,1,22
BIHAR,KAIMUR (BHABUA),RAMGARH,1,0,0,0,0,1
BIHAR,KAIMUR (BHABUA),RAMPUR,2,0,0,0,0,2
BIHAR,KATIHAR,AMDABAD,2,0,0,0,0,2
BIHAR,KATIHAR,AZAMNAGAR,205,2,0,1,3,211
BIHAR,KATIHAR,BALRAMPUR,4,0,0,0,0,4
BIHAR,KATIHAR,BARARI,1,0,0,0,0,1
BIHAR,KATIHAR,BARSOI,2,0,0,0,0,2
BIHAR,KATIHAR,DANDKHORA,3,0,0,0,0,3
BIHAR,KATIHAR,FALKA,1,0,0,0,0,1
BIHAR,KATIHAR,HASANGANJ,2,0,0,0,0,2
BIHAR,KATIHAR,KADWA,7,0,0,0,0,7
BIHAR,KATIHAR,KATIHAR,24,0,0,0,0,24
BIHAR,KATIHAR,KORHA,70,0,0,0,0,70
BIHAR,KATIHAR,PRANPUR,107,0,0,0,0,107
BIHAR,KHAGARIA,ALAULI,14,0,0,0,0,14
BIHAR,KHAGARIA,BELDAUR,493,0,0,0,0,493
BIHAR,KHAGARIA,CHAUTHAM,53,0,0,0,0,53
BIHAR,KHAGARIA,GOGRI,116,0,0,0,0,116
BIHAR,KHAGARIA,KHAGARIA,56,0,0,0,0,56
BIHAR,KHAGARIA,MANSI,145,0,0,0,0,145
BIHAR,KHAGARIA,PARBATTA,6,1,0,0,0,7
BIHAR,KISHANGANJ,BAHADURGANJ,30,0,0,0,0,30
BIHAR,KISHANGANJ,KISHANGANJ,1,0,0,0,0,1
BIHAR,KISHANGANJ,KOCHADHAMAN,2,0,0,0,0,2
BIHAR,KISHANGANJ,TERHAGACHH,1,0,0,0,0,1
BIHAR,KISHANGANJ,THAKURGANJ,10,0,0,0,0,10
BIHAR,LAKHISARAI,BARHIYA,47,1,0,0,0,48
BIHAR,LAKHISARAI,CHANAN,1,0,0,0,0,1
BIHAR,LAKHISARAI,HALSI,0,0,0,1,0,1
BIHAR,LAKHISARAI,LAKHISARAI,15,1,0,0,0,16
BIHAR,LAKHISARAI,PIPARYA,1,0,0,0,0,1
BIHAR,LAKHISARAI,RAMGHAR CHOK,173,0,0,0,0,173
BIHAR,LAKHISARAI,SURYAGARAH,5,0,0,0,0,5
BIHAR,MADHEPURA,ALAMNAGAR,1,0,0,0,0,1
BIHAR,MADHEPURA,BIHARIGANJ,39,0,0,0,0,39
BIHAR,MADHEPURA,CHAUSA,3,0,0,0,0,3
BIHAR,MADHEPURA,GAMHARIA,0,0,0,1,0,1
BIHAR,MADHEPURA,GAWALPARA,3,0,0,0,0,3
BIHAR,MADHEPURA,KUMAR KHAND,4,0,0,0,0,4
BIHAR,MADHEPURA,MADHEPURA,7,0,0,0,0,7
BIHAR,MADHEPURA,MURLIGANJ,3,0,0,0,0,3
BIHAR,MADHEPURA,PURAINI,1,0,0,0,0,1
BIHAR,MADHEPURA,SHANKARPUR,2,0,0,0,0,2
BIHAR,MADHEPURA,SINGHESHWAR,3,0,0,0,0,3
BIHAR,MADHEPURA,UDAKISHUNGANJ,1,0,0,0,0,1
BIHAR,MADHUBANI,BASOPATTI,56,0,0,0,0,56
BIHAR,MADHUBANI,BENIPATTI,1,0,0,0,0,1
BIHAR,MADHUBANI,BISFI,13,0,0,0,0,13
BIHAR,MADHUBANI,GHOGHARDIHA,2,0,0,0,0,2
BIHAR,MADHUBANI,HARLAKHI,2,0,0,0,0,2
BIHAR,MADHUBANI,JAYNAGAR,1,0,0,0,0,1
BIHAR,MADHUBANI,JHANJHARPUR,3,0,0,0,0,3
BIHAR,MADHUBANI,KHUTAUNA,1,0,0,0,0,1
BIHAR,MADHUBANI,LADANIA,7,1,0,0,0,8
BIHAR,MADHUBANI,LAUKHI,2,0,0,0,0,2
BIHAR,MADHUBANI,MADHEPUR,1,0,0,0,0,1
BIHAR,MADHUBANI,MADHWAPUR,9,0,0,0,0,9
BIHAR,MADHUBANI,PANDAUL,5,0,0,0,0,5
BIHAR,MADHUBANI,ROHIKA,260,32,0,8,3,303
BIHAR,MUNGER,ASARGANJ,194,6,0,0,0,200
BIHAR,MUNGER,BARIYARPUR,9,0,0,0,0,9
BIHAR,MUNGER,DHARAHARA,104,20,4,1,0,129
BIHAR,MUNGER,HAWALI KHAGARHPUR,0,20,0,0,0,20
BIHAR,MUNGER,JAMALPUR,19,2,0,0,0,21
BIHAR,MUNGER,SADAR MUNGER,36,29,0,0,0,65
BIHAR,MUNGER,SANGRAMPUR,18,3,0,0,0,21
BIHAR,MUNGER,TARAPUR,332,5,0,0,0,337
BIHAR,MUNGER,TATIA BAMBAR,136,3,0,0,0,139
BIHAR,MUZAFFARPUR,AURAI,2,0,0,0,0,2
BIHAR,MUZAFFARPUR,BANDRA,1,0,0,0,0,1
BIHAR,MUZAFFARPUR,BOCHAHAN,1,0,0,0,0,1
BIHAR,MUZAFFARPUR,GAIGHAT,1,0,0,0,0,1
BIHAR,MUZAFFARPUR,KANTI,1,0,0,0,0,1
BIHAR,MUZAFFARPUR,KURHANI,97,0,0,0,0,97
BIHAR,MUZAFFARPUR,MARWAN,2,0,0,0,0,2
BIHAR,MUZAFFARPUR,MINAPUR,6,0,0,0,0,6
BIHAR,MUZAFFARPUR,MOTIPUR,3,0,0,0,0,3
BIHAR,MUZAFFARPUR,PAROO,10,0,0,0,0,10
BIHAR,MUZAFFARPUR,SAHEBGANJ,1,0,0,0,0,1
BIHAR,MUZAFFARPUR,SAKRA,13,0,0,0,0,13
BIHAR,MUZAFFARPUR,SARAIYA,9,0,0,0,0,9
BIHAR,NALANDA,ASTHAWAN,217,0,0,0,1,218
BIHAR,NALANDA,BEN,19,0,0,0,0,19
BIHAR,NALANDA,BIHARSHARIF,177,1,0,0,0,178
BIHAR,NALANDA,BIND,3,0,0,0,0,3
BIHAR,NALANDA,CHANDI,10,0,0,0,0,10
BIHAR,NALANDA,EKANGARSARAI,21,0,0,0,0,21
BIHAR,NALANDA,GIRIYAK,8,0,0,0,0,8
BIHAR,NALANDA,HARNAUT,43,0,0,0,1,44
BIHAR,NALANDA,HILSA,21,0,0,0,0,21
BIHAR,NALANDA,ISLAMPUR,45,0,0,0,0,45
BIHAR,NALANDA,KARAIPARSURAI,21,0,0,0,0,21
BIHAR,NALANDA,KATRISARAI,109,0,0,0,0,109
BIHAR,NALANDA,NAGARNAUSA,5,0,0,0,0,5
BIHAR,NALANDA,NOORSARAI,75,0,0,0,0,75
BIHAR,NALANDA,PARWALPUR,13,0,0,0,0,13
BIHAR,NALANDA,RAHUI,60,0,1,0,1,62
BIHAR,NALANDA,RAJGIR,162,0,0,0,0,162
BIHAR,NALANDA,SARMERA,61,0,0,0,0,61
BIHAR,NALANDA,THARTHARI,84,0,0,0,0,84
BIHAR,NAWADA,AKBARPUR,130,0,0,0,0,130
BIHAR,NAWADA,GOVINDPUR,92,0,0,0,0,92
BIHAR,NAWADA,HASUA,241,0,0,0,0,241
BIHAR,NAWADA,KASHICHAK,112,35,13,0,1,161
BIHAR,NAWADA,KAWAKOLE,74,0,0,0,0,74
BIHAR,NAWADA,MESKAUR,28,0,0,0,0,28
BIHAR,NAWADA,NARDIGUNJ,255,0,0,0,0,255
BIHAR,NAWADA,NAWADA,53,0,0,0,0,53
BIHAR,NAWADA,PAKRIBRAWAN,95,0,0,0,0,95
BIHAR,NAWADA,ROH,685,0,0,0,0,685
BIHAR,NAWADA,SIRDALA,48,0,0,0,1,49
BIHAR,NAWADA,WARISALIGUNJ,39,0,0,0,0,39
BIHAR,PATNA,ATHAMALGOLA,25,0,0,0,0,25
BIHAR,PATNA,BAKHTIARPUR,595,0,0,0,0,595
BIHAR,PATNA,BARH,9,4,0,0,1,14
BIHAR,PATNA,BELCHCHI,5,0,0,0,1,6
BIHAR,PATNA,BIHTA,669,4,0,0,0,673
BIHAR,PATNA,DANAPUR-CUM-KHAGAUL,1,0,0,0,0,1
BIHAR,PATNA,DHANARUA,7,0,0,0,0,7
BIHAR,PATNA,DULHIN BAZAR,316,7,1,0,2,326
BIHAR,PATNA,FATUHA,8,0,0,0,0,8
BIHAR,PATNA,GHOSWARI,4,0,0,0,0,4
BIHAR,PATNA,KHUSRUPUR,1,0,0,0,0,1
BIHAR,PATNA,MANER,90,1,0,0,0,91
BIHAR,PATNA,MASAURHI,39,0,0,0,0,39
BIHAR,PATNA,MOKAMA,2,0,0,0,0,2
BIHAR,PATNA,NAUBATPUR,186,12,0,7,19,224
BIHAR,PATNA,PALIGANJ,604,0,0,0,5,609
BIHAR,PATNA,PANDARAK,234,2,0,0,0,236
BIHAR,PATNA,PATNA SADAR,5,0,0,0,0,5
BIHAR,PATNA,PHULWARI,130,2,0,0,0,132
BIHAR,PATNA,PUNPUN,12,0,0,0,0,12
BIHAR,PATNA,SAMPATCHAK,115,0,0,0,0,115
BIHAR,PATNA,VIKRAM,103,0,0,0,0,103
BIHAR,PURNIA,AMOUR,8,0,0,0,0,8
BIHAR,PURNIA,BAISA,21,0,0,0,0,21
BIHAR,PURNIA,BAISI,46,0,0,0,0,46
BIHAR,PURNIA,BANMANKHI,157,0,0,0,0,157
BIHAR,PURNIA,BARHARA KOTHI,54,0,0,0,1,55
BIHAR,PURNIA,BHAWANIPUR,2,0,0,0,0,2
BIHAR,PURNIA,DAGARUA,24,0,0,0,0,24
BIHAR,PURNIA,DHAMDAHA,3,0,0,0,0,3
BIHAR,PURNIA,KASBA,18,0,0,0,0,18
BIHAR,PURNIA,KRITYANAND NAGAR,171,0,0,0,0,171
BIHAR,PURNIA,PURNEA EAST,463,0,0,0,0,463
BIHAR,PURNIA,RUPOULI,22,0,0,0,0,22
BIHAR,PURNIA,SRINAGAR,24,0,0,0,0,24
BIHAR,ROHTAS(SASARAM),BIKRAMGANJ,355,0,0,0,0,355
BIHAR,ROHTAS(SASARAM),CHENARI,479,0,0,0,0,479
BIHAR,ROHTAS(SASARAM),DEHRI,279,0,0,0,0,279
BIHAR,ROHTAS(SASARAM),DINARA,201,0,0,0,0,201
BIHAR,ROHTAS(SASARAM),KARAKAT,14,0,0,0,0,14
BIHAR,ROHTAS(SASARAM),KARGAHAR,113,0,0,0,0,113
BIHAR,ROHTAS(SASARAM),KOCHAS,127,1,0,0,0,128
BIHAR,ROHTAS(SASARAM),NASRIGANJ,13,0,0,0,0,13
BIHAR,ROHTAS(SASARAM),NAUHATTA,23,1,0,0,0,24
BIHAR,ROHTAS(SASARAM),NOKHA,34,0,0,0,0,34
BIHAR,ROHTAS(SASARAM),RAJPUR,5,0,0,0,0,5
BIHAR,ROHTAS(SASARAM),ROHTAS,65,0,0,0,0,65
BIHAR,ROHTAS(SASARAM),SANJHAULI,57,0,0,0,0,57
BIHAR,ROHTAS(SASARAM),SASARAM,139,0,0,0,0,139
BIHAR,ROHTAS(SASARAM),SHEOSAGAR,175,0,0,0,0,175
BIHAR,ROHTAS(SASARAM),SURAJPURA,261,0,0,0,0,261
BIHAR,ROHTAS(SASARAM),TILOUTTHU,130,0,0,0,0,130
BIHAR,SAHARSA,BANMA ITAHARI,7,0,0,0,0,7
BIHAR,SAHARSA,KAHARA,0,1,0,0,0,1
BIHAR,SAHARSA,NAUHATTA,3,0,0,0,0,3
BIHAR,SAHARSA,PATARGHAT,80,0,0,0,0,80
BIHAR,SAHARSA,SALKHUA,2,0,0,0,0,2
BIHAR,SAHARSA,SATTAR KATTAIYA,201,0,0,0,0,201
BIHAR,SAHARSA,SAUR BAZAR,1,0,0,0,0,1
BIHAR,SAHARSA,SIMRI BAKHTIARPUR,16,0,0,0,0,16
BIHAR,SAHARSA,SONBARSA,137,0,0,0,0,137
BIHAR,SAMASTIPUR,BIBHUTIPUR,1,1,0,0,0,2
BIHAR,SAMASTIPUR,BITHAN,1,0,0,0,0,1
BIHAR,SAMASTIPUR,DALSINGHSARAI,10,2,0,0,0,12
BIHAR,SAMASTIPUR,HASANPUR,0,3,0,0,0,3
BIHAR,SAMASTIPUR,KALYANPUR,2,14,0,0,0,16
BIHAR,SAMASTIPUR,KHANPUR,3,4,0,0,0,7
BIHAR,SAMASTIPUR,MOHANPUR,4,0,0,0,0,4
BIHAR,SAMASTIPUR,MOHIUDDIN NAGAR,1,0,0,0,0,1
BIHAR,SAMASTIPUR,MORWA,180,1,1,0,0,182
BIHAR,SAMASTIPUR,PATORI,27,0,0,0,0,27
BIHAR,SAMASTIPUR,PUSA,1,0,0,0,0,1
BIHAR,SAMASTIPUR,ROSERA,9,0,0,0,0,9
BIHAR,SAMASTIPUR,SAMASTIPUR,4,0,0,0,0,4
BIHAR,SAMASTIPUR,SARAIRANJAN,6,0,0,0,0,6
BIHAR,SAMASTIPUR,SHIVAJINAGAR,308,0,3,13,2,326
BIHAR,SAMASTIPUR,SINGHIA,1,0,0,0,0,1
BIHAR,SAMASTIPUR,TAJPUR,9,0,0,0,0,9
BIHAR,SAMASTIPUR,UJIYARPUR,2,0,0,0,0,2
BIHAR,SAMASTIPUR,VIDHYAPATINAGAR,91,0,0,0,0,91
BIHAR,SAMASTIPUR,WARISHNAGAR,3,0,0,0,0,3
BIHAR,SARAN,AMNAUR,2,0,0,0,0,2
BIHAR,SARAN,DARIYAPUR,210,0,0,0,0,210
BIHAR,SARAN,DIGHWARA,86,0,0,0,0,86
BIHAR,SARAN,EKMA,6,0,0,0,0,6
BIHAR,SARAN,GARKHA,38,0,0,0,0,38
BIHAR,SARAN,MAKER,3,0,0,0,0,3
BIHAR,SARAN,MANJHI,111,0,0,0,0,111
BIHAR,SARAN,MARAURAH,7,0,0,0,0,7
BIHAR,SARAN,MASHRAKH,2,2,0,0,0,4
BIHAR,SARAN,NAGRA,26,0,0,0,0,26
BIHAR,SARAN,PARSA,3,0,0,0,0,3
BIHAR,SARAN,REVILGANJ,9,0,0,0,0,9
BIHAR,SARAN,SADAR,17,0,0,0,0,17
BIHAR,SARAN,SONPUR,3,0,0,0,0,3
BIHAR,SARAN,TRAIYA,3,0,0,0,0,3
BIHAR,SHEKHPURA,ARIYARI,42,0,0,0,0,42
BIHAR,SHEKHPURA,BARBIGHA,147,1,0,0,0,148
BIHAR,SHEKHPURA,CHEWARA,31,0,0,0,0,31
BIHAR,SHEKHPURA,GHAT KUSUMBHA,7,0,0,0,0,7
BIHAR,SHEKHPURA,SHEKHOPURA SARAI,5,0,0,0,0,5
BIHAR,SHEKHPURA,SHEKHPURA,4,1,0,0,0,5
BIHAR,SHEOHAR,DUMRI KATSARI,8,0,0,0,0,8
BIHAR,SHEOHAR,PIPRAHARI,7,0,0,0,1,8
BIHAR,SHEOHAR,PURNHIYA,3,0,0,0,0,3
BIHAR,SHEOHAR,SHEOHAR,7,0,0,0,0,7
BIHAR,SHEOHAR,TRIYANI,80,0,0,0,0,80
BIHAR,SITAMARHI,BAJPATTI,31,0,0,0,0,31
BIHAR,SITAMARHI,BATHNAHA,6,0,0,0,0,6
BIHAR,SITAMARHI,CHORAUT,1,0,0,0,0,1
BIHAR,SITAMARHI,DUMRA,141,0,0,0,0,141
BIHAR,SITAMARHI,MEJARGANJ,2,0,0,0,0,2
BIHAR,SITAMARHI,NANPUR,3,0,0,0,0,3
BIHAR,SITAMARHI,PARSAUNI,5,0,0,0,0,5
BIHAR,SITAMARHI,PUPARI,1,0,0,0,0,1
BIHAR,SITAMARHI,RIGA,16,1,0,0,0,17
BIHAR,SITAMARHI,SONWARSA,16,0,1,0,0,17
BIHAR,SITAMARHI,SUPPI,8,0,0,0,0,8
BIHAR,SITAMARHI,SURSAND,5,0,0,0,0,5
BIHAR,SIWAN,ANDER,14,0,0,0,0,14
BIHAR,SIWAN,BARHARIA,224,0,0,0,0,224
BIHAR,SIWAN,BHAGWANPUR-HAT,34,0,0,0,0,34
BIHAR,SIWAN,DARAULI,69,1,0,0,0,70
BIHAR,SIWAN,DARAUNDHA,1,0,0,0,0,1
BIHAR,SIWAN,GOREAKOTHI,128,0,0,0,0,128
BIHAR,SIWAN,GUTHANI,68,1,0,0,0,69
BIHAR,SIWAN,HASANPURA,47,0,0,0,0,47
BIHAR,SIWAN,HUSSAINGANJ,6,0,0,0,0,6
BIHAR,SIWAN,JIRADEI,86,0,0,0,0,86
BIHAR,SIWAN,LAKRI NABIGANJ,21,0,0,0,0,21
BIHAR,SIWAN,MAIRWA,0,0,1,0,0,1
BIHAR,SIWAN,NAUTAN,8,17,0,0,0,25
BIHAR,SIWAN,PACHRUKHI,6,0,0,0,0,6
BIHAR,SIWAN,RAGHUNATHPUR,41,1,0,0,0,42
BIHAR,SIWAN,SISWAN,3,3,0,0,0,6
BIHAR,SIWAN,SIWAN,0,0,14,0,0,14
BIHAR,SUPAUL,BASANTPUR,2,0,0,0,1,3
BIHAR,SUPAUL,CHHATAPUR,40,0,0,0,0,40
BIHAR,SUPAUL,KISHANPUR,0,0,0,1,0,1
BIHAR,SUPAUL,MARAUNA,3,0,0,0,0,3
BIHAR,SUPAUL,NIRMALI,1,0,0,0,0,1
BIHAR,SUPAUL,RAGHOPUR,9,0,0,0,0,9
BIHAR,SUPAUL,SARAIGARH BHAPTIYAHI,3,0,0,0,0,3
BIHAR,SUPAUL,SUPAUL,3,0,0,2,0,5
BIHAR,SUPAUL,TRIVENIGANJ,1,0,0,1,0,2
BIHAR,VAISHALI,BHAGWANPUR,0,0,3,0,0,3
BIHAR,VAISHALI,BIDUPUR,1,10,1,0,0,12
BIHAR,VAISHALI,CHEHRAKALA,8,0,0,0,0,8
BIHAR,VAISHALI,DESARI,4,0,0,0,0,4
BIHAR,VAISHALI,GORAUL,16,0,0,0,0,16
BIHAR,VAISHALI,HAJIPUR,0,8,1,0,0,9
BIHAR,VAISHALI,JANDAHA,1,0,5,0,0,6
BIHAR,VAISHALI,LALGANJ,3,0,1,0,0,4
BIHAR,VAISHALI,MAHNAR,7,0,0,0,0,7
BIHAR,VAISHALI,MAHUA,6,0,0,0,0,6
BIHAR,VAISHALI,PATEDHI BELSAR,1,0,0,0,0,1
BIHAR,VAISHALI,PATEPUR,7,0,0,0,0,7
BIHAR,WEST CHAMPARAN,BAGAHA,1,0,0,0,0,1
BIHAR,WEST CHAMPARAN,BETTIAH,1,0,0,0,0,1
BIHAR,WEST CHAMPARAN,CHANPATIA,7,0,0,0,1,8
BIHAR,WEST CHAMPARAN,GAUNAHA,9,0,0,0,0,9
BIHAR,WEST CHAMPARAN,JOGAPATTI,14,0,0,0,0,14
BIHAR,WEST CHAMPARAN,LAURIA,0,1,0,0,0,1
BIHAR,WEST CHAMPARAN,NARKATIAGANJ,1,0,0,0,0,1
BIHAR,WEST CHAMPARAN,NAUTAN,17,0,0,0,0,17
BIHAR,WEST CHAMPARAN,RAMNAGAR,52,0,0,0,0,52
BIHAR,WEST CHAMPARAN,SIDHAW,9,0,0,0,0,9
CHANDIGARH,UT CHANDIGARH,UT CHANDIGARH,0,0,1,1,17,19
CHHATISGARH,BASTER,BADERAJPUR,2,0,0,0,0,2
CHHATISGARH,BASTER,JAGDALPUR,1,0,0,0,0,1
CHHATISGARH,BASTER,MAKADI,1,0,0,0,0,1
CHHATISGARH,BILASPUR,BELHA,39,0,0,33,0,72
CHHATISGARH,BILASPUR,BILASPUR,59,0,2,0,0,61
CHHATISGARH,BILASPUR,GOURELA,142,0,0,0,2,144
CHHATISGARH,BILASPUR,KOTA,12,0,0,3,0,15
CHHATISGARH,BILASPUR,LORMI,8,0,0,0,0,8
CHHATISGARH,BILASPUR,MARWAHI,8,0,0,0,0,8
CHHATISGARH,BILASPUR,MASTURI,19,0,0,0,0,19
CHHATISGARH,BILASPUR,MUNGELI,312,23,4,61,92,492
CHHATISGARH,BILASPUR,PENDRA-ROAD,85,0,3,8,10,106
CHHATISGARH,BILASPUR,TAKHATPUR,464,25,2,5,107,603
CHHATISGARH,DANTEWADA,KUOAKOANDA,1,0,0,0,0,1
CHHATISGARH,DANTEWADA,SUKMA,2,0,0,0,0,2
CHHATISGARH,DHAMTARI,KURUD,2,0,0,0,0,2
CHHATISGARH,DHAMTARI,NAGARI,6,0,0,0,0,6
CHHATISGARH,DURG,BEMETARA,5,0,0,0,0,5
CHHATISGARH,DURG,BERLA,18,0,0,0,0,18
CHHATISGARH,DURG,DHMADHA,5,0,0,0,0,5
CHHATISGARH,DURG,DONDI,2,0,0,0,0,2
CHHATISGARH,DURG,DURG,32,0,0,0,0,32
CHHATISGARH,DURG,GUNDERDEHI,7,0,0,0,0,7
CHHATISGARH,DURG,GURUR,7,0,0,0,0,7
CHHATISGARH,DURG,NAVAGARH,101,0,0,2,3,106
CHHATISGARH,DURG,PATAN,7,0,0,0,0,7
CHHATISGARH,DURG,SAJA,11,0,0,0,0,11
CHHATISGARH,JANJGIR-CHAMPA,AKALTARA,129,0,0,0,0,129
CHHATISGARH,JANJGIR-CHAMPA,BALOADA,8,0,0,0,0,8
CHHATISGARH,JANJGIR-CHAMPA,CHAMPA,13,0,0,0,0,13
CHHATISGARH,JANJGIR-CHAMPA,DABHARA,228,0,1,2,7,238
CHHATISGARH,JANJGIR-CHAMPA,JAIJAIPUR,40,0,0,0,0,40
CHHATISGARH,JANJGIR-CHAMPA,JANJGIR,2,0,0,4,19,25
CHHATISGARH,JANJGIR-CHAMPA,MALKHARODA,761,0,186,14,30,991
CHHATISGARH,JANJGIR-CHAMPA,NAVAGARH,1,0,0,0,0,1
CHHATISGARH,JANJGIR-CHAMPA,PAMGARH,9,0,0,0,0,9
CHHATISGARH,JANJGIR-CHAMPA,SAKTI,1477,0,22,6,94,1599
CHHATISGARH,JASHPUR,PATHALGAON,1,0,0,0,0,1
CHHATISGARH,KANKER,CHARAMA,6,0,0,0,0,6
CHHATISGARH,KAWARDHA,BODHLA,20,0,0,0,1,21
CHHATISGARH,KAWARDHA,KAWARDHA,41,0,0,0,1,42
CHHATISGARH,KAWARDHA,PANDARIYA,5,0,0,0,0,5
CHHATISGARH,KAWARDHA,S. LOHARA,2,0,0,0,0,2
CHHATISGARH,KORIA,BAIKUNTHPUR,2,2,0,0,0,4
CHHATISGARH,MAHASAMUND,MAHASAMUND,1,0,0,0,0,1
CHHATISGARH,MAHASAMUND,PITHOARA,1,0,0,0,0,1
CHHATISGARH,MAHASAMUND,SARIYPALI,1,0,1,0,0,2
CHHATISGARH,RAIGARH,DHARAMJAIGARH,53,0,3,0,46,102
CHHATISGARH,RAIGARH,GHARGODA,1,0,0,0,2,3
CHHATISGARH,RAIGARH,KHARSIYA,42,0,0,0,1,43
CHHATISGARH,RAIGARH,LAILUNGA,3,0,0,0,0,3
CHHATISGARH,RAIGARH,PUSHOR,3,0,2,71,102,178
CHHATISGARH,RAIGARH,RAIGARH,103,0,3,37,140,283
CHHATISGARH,RAIGARH,SARANGARH,25,1,2,0,14,42
CHHATISGARH,RAIGARH,TAMNAR,18,0,2,0,0,20
CHHATISGARH,RAIPUR,ABHANPUR,4,0,0,0,0,4
CHHATISGARH,RAIPUR,ARANG,4,0,0,0,0,4
CHHATISGARH,RAIPUR,BHATAPARA,9,0,0,0,0,9
CHHATISGARH,RAIPUR,BILAIGARH,8,0,1,0,0,9
CHHATISGARH,RAIPUR,BLOUDABAJAR,2,2,0,0,0,4
CHHATISGARH,RAIPUR,CHHURA,1,0,0,0,0,1
CHHATISGARH,RAIPUR,DEVBHOG,1,0,0,0,1,2
CHHATISGARH,RAIPUR,GARIYABAND,15,0,1,0,0,16
CHHATISGARH,RAIPUR,KASDOL,7,0,0,0,0,7
CHHATISGARH,RAIPUR,PALARI,1,0,0,0,0,1
CHHATISGARH,RAIPUR,RAIPUR,8,0,0,0,1,9
CHHATISGARH,RAIPUR,SIMGA,11,0,0,0,0,11
CHHATISGARH,RAIPUR,TILDA,43,0,1,3,23,70
CHHATISGARH,RAJNANDGAON,DONGAR GAON,3,0,0,0,0,3
CHHATISGARH,RAJNANDGAON,DONGAR GARH,7,0,0,0,0,7
CHHATISGARH,RAJNANDGAON,KHAIRAGARH,1,0,0,0,0,1
CHHATISGARH,RAJNANDGAON,MOHLA,4,0,0,0,0,4
CHHATISGARH,RAJNANDGAON,RAJNANDGAON,2,0,0,0,0,2
CHHATISGARH,SURGUJA,AMBIKAPUR (01),10,0,0,2,0,12
CHHATISGARH,SURGUJA,BALRAMPUR (03),1,0,0,0,0,1
CHHATISGARH,SURGUJA,BATAULI (04),1,0,0,0,0,1
CHHATISGARH,SURGUJA,BHAIYATHAN (05),0,0,0,1,2,3
CHHATISGARH,SURGUJA,LAKHANPUR (07),5,0,0,0,0,5
CHHATISGARH,SURGUJA,LUNDRA (08),5,0,0,0,0,5
CHHATISGARH,SURGUJA,PAL (RAMANUJGANJ)  R,1,0,0,0,0,1
CHHATISGARH,SURGUJA,PRATAPPUR (11),14,0,0,0,5,19
CHHATISGARH,SURGUJA,RAJPUR (13),6,0,0,0,1,7
CHHATISGARH,SURGUJA,RAMANUJNAGAR (14),7,0,0,0,3,10
CHHATISGARH,SURGUJA,SITAPUR (17),3,0,0,0,0,3
CHHATISGARH,SURGUJA,SURAJPUR (18),3,0,0,0,0,3
CHHATISGARH,SURGUJA,UDAYPUR (19),0,1,0,0,0,1
CHHATISGARH,SURGUJA,WADAFNAGAR (02),4,0,1,0,0,5
DADRA & NAGAR HAVELI,DADRA & NAGAR HAVELI,AMBOLI,1,0,0,0,0,1
DADRA & NAGAR HAVELI,DADRA & NAGAR HAVELI,DUDHANI,8,0,0,0,0,8
DELHI,ALIPUR,ALIPUR,0,4,0,0,0,4
DELHI,MAHRAULI,MAHRAULI,214,333,148,20,4,719
DELHI,NAJAFGARH,NAJAFGARH,504,0,0,0,0,504
DELHI,NANGLOI,NANGLOI,1,0,0,0,0,1
GOA,NORTH GOA,PERNEM,1,0,0,0,1,2
GOA,NORTH GOA,PONDA,7,0,0,0,0,7
GOA,NORTH GOA,SATTARI,16,0,0,0,0,16
GOA,SOUTH GOA,CANACONA,15,3,0,0,0,18
GOA,SOUTH GOA,MORMUGAO,4,0,0,0,0,4
GUJARAT,AHMEDABAD,BARWALA,65,0,0,0,0,65
GUJARAT,AHMEDABAD,BAVLA,1,0,0,39,272,312
GUJARAT,AHMEDABAD,DASKROI,130,235,254,592,580,1791
GUJARAT,AHMEDABAD,DETROJ-RAMPURA,1,0,0,0,421,422
GUJARAT,AHMEDABAD,DHANDHUKA,0,5,0,0,0,5
GUJARAT,AHMEDABAD,DHOLKA,538,32,3,459,391,1423
GUJARAT,AHMEDABAD,MANDAL,7,85,0,0,242,334
GUJARAT,AHMEDABAD,RANPUR,267,215,36,0,2,520
GUJARAT,AHMEDABAD,SANAND,140,313,12,12,161,638
GUJARAT,AHMEDABAD,VIRAMGAM,0,0,0,161,370,531
GUJARAT,AMRELI,AMRELI,3,0,0,0,0,3
GUJARAT,AMRELI,BABRA,5,0,0,0,1,6
GUJARAT,AMRELI,BAGASARA,1,0,0,0,0,1
GUJARAT,AMRELI,DHARI,2,0,0,0,0,2
GUJARAT,AMRELI,KHAMBHA,1,0,0,0,0,1
GUJARAT,AMRELI,KUNKAVAV VADIA,1,0,0,0,0,1
GUJARAT,AMRELI,LATHI,159,1,1,5,1,167
GUJARAT,AMRELI,SAVARKUNDLA,2,0,0,0,6,8
GUJARAT,ANAND,ANAND,242,23,6,3,0,274
GUJARAT,ANAND,ANKLAV,304,4,29,0,0,337
GUJARAT,ANAND,BORSAD,665,94,51,80,45,935
GUJARAT,ANAND,KHAMBHAT,422,362,50,0,0,834
GUJARAT,ANAND,PETLAD,11,0,0,0,0,11
GUJARAT,ANAND,SOJITRA,6,2,3,6,0,17
GUJARAT,ANAND,TARAPUR,28,4,0,0,0,32
GUJARAT,ANAND,UMRETH,10,0,1,29,2,42
GUJARAT,BANASKANTHA,AMIRGADH,11,0,0,0,2,13
GUJARAT,BANASKANTHA,BHABHAR,1725,0,0,0,0,1725
GUJARAT,BANASKANTHA,DANTA,30,14,7,0,2,53
GUJARAT,BANASKANTHA,DANTIWADA,105,0,1,857,2639,3602
GUJARAT,BANASKANTHA,DEESA,62,0,32,5271,8330,13695
GUJARAT,BANASKANTHA,DEODAR,5787,0,0,0,1,5788
GUJARAT,BANASKANTHA,DHANERA,4943,2,13,3301,1823,10082
GUJARAT,BANASKANTHA,KANKAREJ,5054,0,0,0,0,5054
GUJARAT,BANASKANTHA,PALANPUR,1615,0,1,1,136,1753
GUJARAT,BANASKANTHA,THARAD,11854,0,0,0,2,11856
GUJARAT,BANASKANTHA,VADAGAM,1695,0,0,1,953,2649
GUJARAT,BANASKANTHA,WAV,831,0,0,0,0,831
GUJARAT,BHARUCH,ANKLESVAR,3,0,0,0,0,3
GUJARAT,BHARUCH,BHARUCH,130,23,0,0,0,153
GUJARAT,BHARUCH,JHAGADIA,3,0,0,0,0,3
GUJARAT,BHARUCH,VAGRA,0,0,0,1,0,1
GUJARAT,BHAVNAGAR,BHAVNAGAR,20,0,0,0,0,20
GUJARAT,BHAVNAGAR,GARIADHAR,1,0,0,0,0,1
GUJARAT,BHAVNAGAR,GHOGHA,1,0,0,0,0,1
GUJARAT,BHAVNAGAR,SIHOR,1,0,0,0,0,1
GUJARAT,DAHOD,DEVGADH BARIA,1,0,0,0,0,1
GUJARAT,DAHOD,DHANPUR,1,0,0,0,0,1
GUJARAT,DAHOD,JHALOD,1,0,0,0,0,1
GUJARAT,DAHOD,LIMKHEDA,1,0,0,0,0,1
GUJARAT,DANG,DANG,1,1,0,0,0,2
GUJARAT,GANDHINAGAR,DEHGAM,453,663,230,238,569,2153
GUJARAT,GANDHINAGAR,GANDHINAGAR,4,441,17,399,2126,2987
GUJARAT,GANDHINAGAR,KALOL,2,1,47,46,883,979
GUJARAT,JAMNAGAR,DHROL,2,0,0,0,0,2
GUJARAT,JAMNAGAR,JAMJODHPUR,1,0,0,0,0,1
GUJARAT,JAMNAGAR,JAMNAGAR,0,0,0,0,1,1
GUJARAT,JUNAGADH,BHESANA,104,0,0,0,241,345
GUJARAT,JUNAGADH,JUNAGADH,2,0,0,0,0,2
GUJARAT,JUNAGADH,KESHOD,6,0,0,0,0,6
GUJARAT,JUNAGADH,KODINAR,1,0,0,0,0,1
GUJARAT,JUNAGADH,MALIA,4,0,0,0,2,6
GUJARAT,JUNAGADH,MANAVADAR,1,0,0,0,0,1
GUJARAT,JUNAGADH,MANGROL,41,0,1,0,0,42
GUJARAT,JUNAGADH,MENDARDA,250,0,0,0,36,286
GUJARAT,JUNAGADH,PATAN-VERAVAL,6,0,0,0,18,24
GUJARAT,JUNAGADH,SUTRAPADA,1,0,0,0,0,1
GUJARAT,JUNAGADH,TALALA,0,0,0,1,32,33
GUJARAT,JUNAGADH,VATHALI,2,0,0,0,87,89
GUJARAT,JUNAGADH,VISAVADAR,474,1,3,41,1397,1916
GUJARAT,KACHCHH,ABDASA,104,0,0,0,0,104
GUJARAT,KACHCHH,ANJAR,1096,56,730,66,102,2050
GUJARAT,KACHCHH,BHACHAU,135,358,587,20,9,1109
GUJARAT,KACHCHH,BHUJ,844,31,1186,690,335,3086
GUJARAT,KACHCHH,GANDHIDHAM,1,25,78,23,37,164
GUJARAT,KACHCHH,LAKHPAT,5,20,10,2,3,40
GUJARAT,KACHCHH,MANDVI,947,864,846,850,327,3834
GUJARAT,KACHCHH,MUNDRA,60,76,116,37,27,316
GUJARAT,KACHCHH,NAKHATRANA,767,362,625,667,196,2617
GUJARAT,KACHCHH,RAPAR,4,1,0,0,0,5
GUJARAT,KHEDA,BALASINOR,0,2,0,0,60,62
GUJARAT,KHEDA,KAPADVANJ,322,90,4,6,6,428
GUJARAT,KHEDA,KATHLAL,532,179,29,9,42,791
GUJARAT,KHEDA,KHEDA,73,338,0,0,0,411
GUJARAT,KHEDA,MAHUDHA,8,11,16,9,0,44
GUJARAT,KHEDA,MATAR,0,10,0,0,0,10
GUJARAT,KHEDA,MEHMEDABAD,20,66,1,1,2,90
GUJARAT,KHEDA,NADIAD,13,9,2,1,0,25
GUJARAT,KHEDA,THASRA,472,154,22,12,15,675
GUJARAT,KHEDA,VIRPUR,95,91,30,36,31,283
GUJARAT,MEHSANA,BECHARAJI,10,5,2,14,528,559
GUJARAT,MEHSANA,KADI,23,51,151,209,1591,2025
GUJARAT,MEHSANA,KHERALU,2212,384,76,17,324,3013
GUJARAT,MEHSANA,MEHSANA,19,15,43,193,1871,2141
GUJARAT,MEHSANA,SATLASANA,2412,68,30,19,267,2796
GUJARAT,MEHSANA,UNJHA,40,34,6,30,658,768
GUJARAT,MEHSANA,VADNAGAR,698,0,0,0,0,698
GUJARAT,MEHSANA,VIJAPUR,142,148,334,373,1125,2122
GUJARAT,MEHSANA,VISNAGAR,86,22,14,80,1140,1342
GUJARAT,NARMADA,DEDIAPADA,30,28,0,1,9,68
GUJARAT,NARMADA,NANDOD,581,116,0,10,4,711
GUJARAT,NARMADA,SAGBARA,9,1,0,0,0,10
GUJARAT,NARMADA,TILAKWADA,104,28,0,0,0,132
GUJARAT,NAVSARI,CHIKHLI,3,0,0,0,0,3
GUJARAT,NAVSARI,GANDEVI,4,0,0,0,0,4
GUJARAT,NAVSARI,JALALPORE,5,0,0,0,0,5
GUJARAT,NAVSARI,NAVSARI,1,0,0,0,0,1
GUJARAT,PANCHMAHAL,GHOGHAMBA,15,2,0,0,0,17
GUJARAT,PANCHMAHAL,HALOL,269,6,0,2,0,277
GUJARAT,PANCHMAHAL,JAMBUGHODA,12,0,0,3,0,15
GUJARAT,PANCHMAHAL,KALOL,3,0,0,0,0,3
GUJARAT,PANCHMAHAL,KHANPUR,2,0,0,0,0,2
GUJARAT,PANCHMAHAL,SHEHERA,4,0,0,0,0,4
GUJARAT,PATAN,CHANASMA,0,3,0,24,711,738
GUJARAT,PATAN,HARIJ,2,4,14,34,539,593
GUJARAT,PATAN,PATAN,3,45,95,131,1758,2032
GUJARAT,PATAN,RADHANPUR,14,9,0,0,229,252
GUJARAT,PATAN,SAMI,0,0,0,0,607,607
GUJARAT,PATAN,SANTALPUR,1,1,2,11,89,104
GUJARAT,PATAN,SIDHPUR,1,0,1,0,1461,1463
GUJARAT,PATAN,VAGDOD,1,37,141,120,479,778
GUJARAT,PORBANDAR,KUTIYANA,2,1,0,0,0,3
GUJARAT,PORBANDAR,RANAVAV,21,8,0,0,0,29
GUJARAT,RAJKOT,DHORAJI,8,15,126,65,5,219
GUJARAT,RAJKOT,GONDAL,14,33,79,35,132,293
GUJARAT,RAJKOT,JAMKANDORNA,22,4,45,63,51,185
GUJARAT,RAJKOT,JASDAN,1,11,30,12,0,54
GUJARAT,RAJKOT,JETPUR,164,40,12,3,0,219
GUJARAT,RAJKOT,KOTADA SANGANI,0,3,0,6,6,15
GUJARAT,RAJKOT,LODHIKA,76,48,82,15,11,232
GUJARAT,RAJKOT,MALIYA,1,0,0,2,4,7
GUJARAT,RAJKOT,MORVI,9,4,9,128,288,438
GUJARAT,RAJKOT,PADDHARI,20,31,5,21,27,104
GUJARAT,RAJKOT,RAJKOT,7,1,7,29,45,89
GUJARAT,RAJKOT,TANKARA,0,1,0,5,0,6
GUJARAT,RAJKOT,UPLETA,14,0,0,6,2,22
GUJARAT,RAJKOT,WANKANER,70,196,280,370,742,1658
GUJARAT,SABARKANTHA,BHILODA,1922,213,3,19,473,2630
GUJARAT,SABARKANTHA,DHANSURA,1,0,0,0,0,1
GUJARAT,SABARKANTHA,HIMATNAGAR,185,0,0,0,0,185
GUJARAT,SABARKANTHA,IDAR,19,0,63,212,4630,4924
GUJARAT,SABARKANTHA,KHEDBRAHMA,9,0,0,0,0,9
GUJARAT,SABARKANTHA,MEGHRAJ,114,406,38,7,819,1384
GUJARAT,SABARKANTHA,MODASA,7,3,6,0,5,21
GUJARAT,SABARKANTHA,PRANTIJ,1,1,0,0,0,2
GUJARAT,SABARKANTHA,VADALI,1,0,0,1,0,2
GUJARAT,SABARKANTHA,VIJAYNAGAR,2,3,1,0,0,6
GUJARAT,SURAT,CHORASI,7,0,0,0,0,7
GUJARAT,SURAT,MANDVI,1,0,0,0,0,1
GUJARAT,SURENDRANAGAR,CHOTILA,77,0,0,0,18,95
GUJARAT,SURENDRANAGAR,CHUDA,13,60,0,0,206,279
GUJARAT,SURENDRANAGAR,DASADA,45,6,0,3,106,160
GUJARAT,SURENDRANAGAR,DHRANGADHRA,1040,107,77,503,916,2643
GUJARAT,SURENDRANAGAR,HALVAD,2,4,2,109,6224,6341
GUJARAT,SURENDRANAGAR,LIMDI,11,3,1,1,1,17
GUJARAT,SURENDRANAGAR,MULI,254,1582,963,281,158,3238
GUJARAT,SURENDRANAGAR,SAYLA,86,460,191,23,89,849
GUJARAT,SURENDRANAGAR,WADHWAN,153,179,287,146,204,969
GUJARAT,VADODARA,CHHOTA UDAIPUR,5,0,0,0,0,5
GUJARAT,VADODARA,DABHOI,503,62,1,1,19,586
GUJARAT,VADODARA,JETPUR  PAVI,119,0,0,0,0,119
GUJARAT,VADODARA,KARJAN,1941,207,1,0,5,2154
GUJARAT,VADODARA,KAVANT,2,0,0,0,0,2
GUJARAT,VADODARA,NASVADI,86,2,0,1,1,90
GUJARAT,VADODARA,PADARA,601,109,2,0,4,716
GUJARAT,VADODARA,SANKHEDA,117,1,0,0,2,120
GUJARAT,VADODARA,SAVLI,25,7,0,0,0,32
GUJARAT,VADODARA,SINOR,178,7,1,0,31,217
GUJARAT,VADODARA,VADODARA,1053,40,1,0,0,1094
GUJARAT,VADODARA,VAGHODIA,653,14,3,1,3,674
HARYANA,AMBALA,AMBALA,612,2655,0,0,0,3267
HARYANA,AMBALA,AMBALA-1,9,32,0,0,0,41
HARYANA,AMBALA,BARARA,82,439,0,0,0,521
HARYANA,AMBALA,NARAINGARH,43,222,0,0,0,265
HARYANA,AMBALA,SAHA,1,2,0,0,0,3
HARYANA,AMBALA,SHAHAZADPUR,104,366,0,0,0,470
HARYANA,BHIWANI,BADHRA,152,651,0,0,0,803
HARYANA,BHIWANI,BAWANI-KHERA,13,50,0,0,0,63
HARYANA,BHIWANI,BHIWANI,43,157,0,0,0,200
HARYANA,BHIWANI,DADRI-I,111,456,0,0,0,567
HARYANA,BHIWANI,DADRI-II,61,280,0,0,0,341
HARYANA,BHIWANI,KURU,2,11,0,0,0,13
HARYANA,BHIWANI,LOHARU,217,831,0,0,0,1048
HARYANA,BHIWANI,SIWANI,130,528,0,0,0,658
HARYANA,BHIWANI,TOSHAM,24,93,0,0,0,117
HARYANA,FARIDABAD,FARIDABAD,3,25,0,0,0,28
HARYANA,FATEHABAD,BHUNA,59,215,0,0,0,274
HARYANA,FATEHABAD,FATEHABAD,199,766,0,0,0,965
HARYANA,FATEHABAD,RATIA,49,175,0,0,0,224
HARYANA,FATEHABAD,TOHANA,300,1242,0,0,0,1542
HARYANA,GURGAON,FARUKH NAGAR,100,462,0,0,0,562
HARYANA,GURGAON,GURGAON,52,231,0,0,0,283
HARYANA,GURGAON,PATAUDI,148,540,0,0,0,688
HARYANA,GURGAON,SOHNA,69,397,0,0,0,466
HARYANA,HISSAR,AGROHA,17,116,0,0,0,133
HARYANA,HISSAR,BARWALA,4,21,0,0,0,25
HARYANA,HISSAR,HISSAR-II,37,148,0,0,0,185
HARYANA,HISSAR,UKLANA,11,83,0,0,0,94
HARYANA,JHAJJAR,BAHADURGARH,120,445,0,0,0,565
HARYANA,JHAJJAR,BERI,9,33,0,0,0,42
HARYANA,JHAJJAR,JHAJJAR,58,386,0,0,0,444
HARYANA,JHAJJAR,MATANHAIL,113,510,0,0,0,623
HARYANA,JHAJJAR,SAHLAWAS,104,568,0,0,0,672
HARYANA,JIND,ALEWA,19,96,0,0,0,115
HARYANA,JIND,JIND,28,102,0,0,0,130
HARYANA,JIND,JULANA,70,340,0,0,0,410
HARYANA,JIND,NARWANA,106,405,0,0,0,511
HARYANA,JIND,PILLU KHERA,44,169,0,0,0,213
HARYANA,JIND,SAFIDON,20,130,0,0,0,150
HARYANA,JIND,UCHANA,56,290,0,0,0,346
HARYANA,KAITHAL,GUHLA,376,1581,0,0,0,1957
HARYANA,KAITHAL,KAITHAL,206,929,0,0,0,1135
HARYANA,KAITHAL,KALAYAT,66,278,0,0,0,344
HARYANA,KAITHAL,PUNDRI,141,604,0,0,0,745
HARYANA,KAITHAL,RAJOND,59,177,0,0,0,236
HARYANA,KARNAL,ASSANDH,282,1283,0,0,0,1565
HARYANA,KARNAL,GHARAUNDA,158,700,0,0,0,858
HARYANA,KARNAL,INDRI,148,567,0,0,0,715
HARYANA,KARNAL,KARNAL,132,662,0,0,0,794
HARYANA,KARNAL,NILOKHERI,240,1016,0,0,0,1256
HARYANA,KARNAL,NISSING,16,63,0,0,0,79
HARYANA,KURUKSHETRA,BABAIN,2,24,0,0,0,26
HARYANA,KURUKSHETRA,LADWA,0,1,0,0,0,1
HARYANA,KURUKSHETRA,PEHOWA,483,1891,0,0,0,2374
HARYANA,KURUKSHETRA,SHAHBAD,110,541,0,0,0,651
HARYANA,KURUKSHETRA,THANESAR,96,448,0,0,0,544
HARYANA,MAHENDRAGARH,ATELI NANGAL,56,336,0,0,0,392
HARYANA,MAHENDRAGARH,KANINA,3,15,0,0,0,18
HARYANA,MAHENDRAGARH,MAHENDRAGARH,12,61,0,0,0,73
HARYANA,MAHENDRAGARH,NANGAL CHAUDHARY,165,701,0,0,0,866
HARYANA,MAHENDRAGARH,NARNAUL,23,120,0,0,0,143
HARYANA,MEWAT,FEROZEPUR JHIRKA,157,715,0,0,0,872
HARYANA,MEWAT,NAGINA,98,387,0,0,0,485
HARYANA,MEWAT,NUH,203,812,0,0,0,1015
HARYANA,MEWAT,PUNHANA,72,257,0,0,0,329
HARYANA,MEWAT,TAORU,149,522,0,0,0,671
HARYANA,PANCHKULA,BARWALA,14,55,0,0,0,69
HARYANA,PANCHKULA,PINJORE,18,79,0,0,0,97
HARYANA,PANCHKULA,RAIPUR RANI,41,141,0,0,0,182
HARYANA,PANIPAT,BAPAULI,124,563,0,0,0,687
HARYANA,PANIPAT,ISRANA,53,272,0,0,0,325
HARYANA,PANIPAT,MADLAUDA,86,323,0,0,0,409
HARYANA,PANIPAT,PANIPAT,123,498,0,0,0,621
HARYANA,PANIPAT,SMALKHA,82,443,0,0,0,525
HARYANA,REWARI,BAWAL,38,235,0,0,0,273
HARYANA,REWARI,JATUSANA,33,110,0,0,0,143
HARYANA,REWARI,KHOL,10,32,0,0,0,42
HARYANA,REWARI,NAHAR,58,212,0,0,0,270
HARYANA,REWARI,REWARI,58,255,0,0,0,313
HARYANA,ROHTAK,KALANAUR,28,132,0,0,0,160
HARYANA,ROHTAK,LAKHAN MAJRA,11,50,0,0,0,61
HARYANA,ROHTAK,ROHTAK,24,92,0,0,0,116
HARYANA,SIRSA,BARAGUDHA,29,96,0,0,0,125
HARYANA,SIRSA,ELLENABAD,29,114,0,0,0,143
HARYANA,SIRSA,NATHUSARI CHOPTA,56,281,0,0,0,337
HARYANA,SIRSA,ODHAN,36,134,0,0,0,170
HARYANA,SIRSA,RANIA,54,201,0,0,0,255
HARYANA,SIRSA,SIRSA,377,1750,0,0,0,2127
HARYANA,SONEPAT,GANAUR,106,477,0,0,0,583
HARYANA,SONEPAT,GOHANA,26,93,0,0,0,119
HARYANA,SONEPAT,KHARKHODA,138,499,0,0,0,637
HARYANA,SONEPAT,RAI,76,306,0,0,0,382
HARYANA,SONEPAT,SONEPAT,136,678,0,0,0,814
HARYANA,YAMUNANAGAR,BILASPUR,66,276,0,0,0,342
HARYANA,YAMUNANAGAR,CHHACHHRAULI,8,26,0,0,0,34
HARYANA,YAMUNANAGAR,JAGADHARI,20,110,0,0,0,130
HARYANA,YAMUNANAGAR,MUSTAFABAD,5,49,0,0,0,54
HARYANA,YAMUNANAGAR,RADAUR,9,14,0,0,0,23
HARYANA,YAMUNANAGAR,SADHAURA,83,377,0,0,0,460
HIMACHAL PRADESH,Bilaspur,NAINA DEVI (ST),2,0,0,0,0,2
HIMACHAL PRADESH,Hamirpur,NADAUN,3,0,0,0,0,3
HIMACHAL PRADESH,Kangra,FATEHPUR (ST),0,0,10,0,8,18
HIMACHAL PRADESH,Kangra,INDORA,27,10,6,2,1,46
HIMACHAL PRADESH,Kangra,JASWAN,1,0,0,0,0,1
HIMACHAL PRADESH,Kangra,JAWALI,5,2,12,0,4,23
HIMACHAL PRADESH,Kangra,NURPUR,1,17,12,0,0,30
HIMACHAL PRADESH,Mandi,MANDI,1,0,0,0,0,1
HIMACHAL PRADESH,Sirmaur,PAONTA SAHIB,38,1,0,0,1,40
HIMACHAL PRADESH,Solan,KASAULI,1,31,4,7,1,44
HIMACHAL PRADESH,Solan,NALAGARH,25,3,3,0,6,37
HIMACHAL PRADESH,Una,AMB,30,41,14,7,1,93
HIMACHAL PRADESH,Una,BANGANA,1,0,0,1,0,2
HIMACHAL PRADESH,Una,HAROLI (ST),18,3,10,5,4,40
HIMACHAL PRADESH,Una,UNA,53,17,10,5,6,91
JAMMU & KASHMIR,JAMMU,BHALWAL,1,0,0,0,0,1
JAMMU & KASHMIR,JAMMU,BISHNAH,14,0,0,0,0,14
JAMMU & KASHMIR,JAMMU,R. S. PURA,19,9,0,0,0,28
JAMMU & KASHMIR,JAMMU,SAMBA,3,1,0,0,0,4
JAMMU & KASHMIR,JAMMU,SATWARI,2,0,0,0,0,2
JAMMU & KASHMIR,JAMMU,VIJAYPUR,3,1,0,0,0,4
JAMMU & KASHMIR,KATHUA,BARNOTI,24,0,0,0,0,24
JAMMU & KASHMIR,KATHUA,HIRANAGAR,1,0,0,0,0,1
JAMMU & KASHMIR,KATHUA,KATHUA,2,0,0,0,0,2
JHARKHAND,CHATRA,CHATRA,2,0,0,0,0,2
JHARKHAND,CHATRA,ITKHORI,1,0,0,0,0,1
JHARKHAND,CHATRA,PRATAPPUR,1,0,0,0,0,1
JHARKHAND,CHATRA,TANDVA,1,0,0,0,0,1
JHARKHAND,DEOGHAR,DEOGHAR,141,0,0,3,2,146
JHARKHAND,DEOGHAR,MADHUPUR,3,0,0,0,0,3
JHARKHAND,DEOGHAR,MOHANPUR,4,0,0,0,0,4
JHARKHAND,DHANBAD,BAGHMARA,5,0,0,0,0,5
JHARKHAND,DHANBAD,NIRSA,4,0,0,0,0,4
JHARKHAND,DHANBAD,TUNDI,1,0,0,0,0,1
JHARKHAND,EAST SINGHBHUM,BAHRAGORA,48,0,0,1,0,49
JHARKHAND,EAST SINGHBHUM,CHAKULIYA,24,1,0,0,0,25
JHARKHAND,EAST SINGHBHUM,DHALBHUMGARH,1,0,0,0,0,1
JHARKHAND,EAST SINGHBHUM,PATAMDA,1,0,0,0,0,1
JHARKHAND,GARHWA,BHANDARIYA,3,2,0,0,0,5
JHARKHAND,GARHWA,KANDI,13,0,0,0,0,13
JHARKHAND,GARHWA,MANJHIAON,4,0,0,0,0,4
JHARKHAND,GARHWA,MERAL,3,0,0,0,0,3
JHARKHAND,GARHWA,RANKA,4,0,0,0,0,4
JHARKHAND,GIRIDIH,DUMARI,4,0,0,0,0,4
JHARKHAND,GIRIDIH,GANDEY,1,0,0,0,0,1
JHARKHAND,GIRIDIH,JAMUA,1,0,0,0,0,1
JHARKHAND,GIRIDIH,TISRI,2,0,0,0,0,2
JHARKHAND,GODDA,GODDA,1,0,0,0,0,1
JHARKHAND,GODDA,MAHAGAMA,1,0,0,0,0,1
JHARKHAND,GODDA,MEHRAMA,5,0,0,0,0,5
JHARKHAND,GODDA,PORAIYAHAT,3,0,0,0,0,3
JHARKHAND,GODDA,THAKUR GANGRI,1,0,0,0,0,1
JHARKHAND,GUMLA,BASIA,1,0,0,0,0,1
JHARKHAND,GUMLA,GHAGHRA,2,0,0,0,0,2
JHARKHAND,GUMLA,GUMLA,2,0,0,0,0,2
JHARKHAND,GUMLA,KAMDARA,2,0,0,0,0,2
JHARKHAND,GUMLA,PALKOT,1,0,0,0,0,1
JHARKHAND,GUMLA,SISAI,4,0,0,0,0,4
JHARKHAND,HAZARIBAGH,BARKAGAON,1,0,0,0,0,1
JHARKHAND,JAMTARA,KUNDHIT,2,0,0,0,0,2
JHARKHAND,JAMTARA,NALA,1,0,0,0,0,1
JHARKHAND,KHUNTI,MURHU,1,0,0,0,0,1
JHARKHAND,KODERMA,JAINAGAR,1,0,0,0,0,1
JHARKHAND,KODERMA,MARKATCHHO,1,0,0,0,0,1
JHARKHAND,LATEHAR,CHANDVA,1,0,0,0,0,1
JHARKHAND,LOHARDAGA,KUDU,2,0,0,0,0,2
JHARKHAND,PAKUR,AMRAPARA,69,17,0,0,0,86
JHARKHAND,PAKUR,LITTIPARA,5,0,0,0,0,5
JHARKHAND,PAKUR,MAHESHPUR,1,4,0,0,0,5
JHARKHAND,PAKUR,PAKUR,1,0,0,0,0,1
JHARKHAND,PAKUR,PAKURIYA,4,0,0,0,0,4
JHARKHAND,PALAMU,BISHRAMPUR,2,0,0,0,0,2
JHARKHAND,PALAMU,CHHATARPUR,1,0,0,0,0,1
JHARKHAND,PALAMU,HARIHARGANJ,1,0,0,0,0,1
JHARKHAND,PALAMU,HUSSAINABAD,2,0,0,0,0,2
JHARKHAND,PALAMU,LESLIGANJ,3,0,0,0,0,3
JHARKHAND,PALAMU,MANATU,3,0,0,0,0,3
JHARKHAND,PALAMU,PANDU,2,0,0,0,0,2
JHARKHAND,PALAMU,SADAR DALTONGANJ,1,0,0,0,0,1
JHARKHAND,RANCHI,ANGARA,1,0,0,0,0,1
JHARKHAND,RANCHI,BERO,1,0,0,0,0,1
JHARKHAND,RANCHI,BUDMU,1,0,0,0,0,1
JHARKHAND,RANCHI,KANKE,2,0,0,0,0,2
JHARKHAND,RANCHI,LAPUNG,8,0,0,0,0,8
JHARKHAND,RANCHI,SILLI,1,0,0,0,0,1
JHARKHAND,RANCHI,SONAHATU,1,0,0,0,0,1
JHARKHAND,SAHEBGANJ,BARHARWA,0,2,0,0,0,2
JHARKHAND,SAHEBGANJ,BARHET,8,0,0,0,0,8
JHARKHAND,SAHEBGANJ,BORIYO,0,2,0,0,0,2
JHARKHAND,SAHEBGANJ,RAJMAHAL,22,0,0,0,0,22
JHARKHAND,SAHEBGANJ,SAHEBGANJ,73,0,1,0,0,74
JHARKHAND,SARAIKELA,CHANDIL,1,0,0,0,0,1
JHARKHAND,SARAIKELA,KUCHAI,1,0,0,0,0,1
JHARKHAND,SIMDEGA,JALDEGA,5,0,0,0,0,5
JHARKHAND,SIMDEGA,KURDEG,1,0,0,0,0,1
JHARKHAND,SIMDEGA,THETHAI TANGAR,2,0,0,0,0,2
KERALA,ERANAKULAM,EDAPPALY,1,1,0,0,0,2
KERALA,ERANAKULAM,THIPPUNITHURA,1,0,0,0,0,1
KERALA,ERANAKULAM,VAZHAKULAM,1,0,0,1,0,2
KERALA,IDDUKKI,AZHUTHA,12,0,12,2,0,26
KERALA,IDDUKKI,DEVIKULAM,0,0,16,2,0,18
KERALA,IDDUKKI,KATTAPPANA,7,48,120,17,25,217
KERALA,IDDUKKI,NEDUMKANDAM,3,33,37,2,0,75
KERALA,IDDUKKI,THODUPUZHA,1,0,0,0,0,1
KERALA,KANNUR,IRIKKUR,0,1,2,2,3,8
KERALA,KANNUR,PAYYANNUR,0,4,0,0,1,5
KERALA,KANNUR,THALIPARAMBA,11,2,0,1,18,32
KERALA,KASARAGODE,KANHANGAD,5,5,6,0,1,17
KERALA,KASARAGODE,KASARAGODE,7,4,10,14,6,41
KERALA,KOZHIKODE,BALUSSERY,2,0,0,0,0,2
KERALA,KOZHIKODE,KUNNAMANGALAM,1,0,0,0,0,1
KERALA,MALAPPURAM,KONDOTTY,10,0,0,0,0,10
KERALA,MALAPPURAM,KUTTIPPURAM,10,2,2,0,0,14
KERALA,MALAPPURAM,MALAPPURAM,7,0,0,0,0,7
KERALA,MALAPPURAM,NILAMBOOR,1,0,0,0,0,1
KERALA,MALAPPURAM,THIRUR,6,0,0,0,0,6
KERALA,MALAPPURAM,VENGARA,1,0,0,0,0,1
KERALA,PALAKKAD,ALATHUR,40,33,11,14,14,112
KERALA,PALAKKAD,ATTAPPADY,2,0,0,0,0,2
KERALA,PALAKKAD,CHITTURTHATHAMANG MU,4,5,3,3,0,15
KERALA,PALAKKAD,CHITUR,44,17,16,5,21,103
KERALA,PALAKKAD,KOLLENGODE,30,0,3,0,39,72
KERALA,PALAKKAD,KUZHALMANNAM,25,2,1,9,2,39
KERALA,PALAKKAD,MALAMPUZHA,26,12,1,0,0,39
KERALA,PALAKKAD,NENMARA,6,0,0,0,0,6
KERALA,PALAKKAD,OTTAPPALAM MUNI,1,0,0,0,0,1
KERALA,PALAKKAD,PATTAMBI,1,0,0,0,1,2
KERALA,PATHANAMTHITTA,MALLAPPALLY,7,0,0,0,0,7
KERALA,PATHANAMTHITTA,RANNI,0,1,1,2,0,4
KERALA,PATHANAMTHITTA,THIRUVALLA MUNI,2,0,0,0,0,2
KERALA,THIRUVANANTHAPURAM,KAZHAKUTTOM,0,0,0,1,0,1
KERALA,THIRUVANANTHAPURAM,VAMANAPURAM,1,0,0,0,0,1
KERALA,THRISSUR,CHERPU,0,3,0,0,1,4
KERALA,THRISSUR,CHOWANNUR,23,0,21,0,2,46
KERALA,THRISSUR,KODUNGALLUR,1,0,0,0,0,1
KERALA,THRISSUR,MALA,26,0,4,4,1,35
KERALA,THRISSUR,MATHILAKOM,1,0,0,0,0,1
KERALA,THRISSUR,MULLASSERY,2,0,0,0,0,2
KERALA,THRISSUR,PAZHAYANNUR,15,3,6,2,0,26
KERALA,THRISSUR,PUZHAKKAL,3,0,0,0,0,3
KERALA,THRISSUR,VADAKKANCHERRY,0,0,0,0,14,14
KERALA,THRISSUR,VELLANGALLUR,8,0,0,0,0,8
KERALA,WAYANAD,KALPETTA,0,2,0,1,0,3
KERALA,WAYANAD,MANANTHAVADI,1,0,0,0,0,1
KERALA,WAYANAD,SULTHANBATHERI,11,1,1,0,0,13
MADHYA PRADESH,ANUPPUR,ANUPPUR,7,0,0,0,0,7
MADHYA PRADESH,ANUPPUR,JAITHARI,135,0,0,0,0,135
MADHYA PRADESH,ANUPPUR,KOTMA,2,0,0,0,0,2
MADHYA PRADESH,ANUPPUR,PUSHPRAJGARH,9,0,0,0,0,9
MADHYA PRADESH,Ashok Nagar,ASHOKNAGAR,866,0,0,0,0,866
MADHYA PRADESH,Ashok Nagar,CHANDERI,1,0,0,0,0,1
MADHYA PRADESH,Ashok Nagar,EHSAGADH,1817,0,0,0,0,1817
MADHYA PRADESH,Ashok Nagar,MUNGAWALI,305,0,0,0,0,305
MADHYA PRADESH,BALAGHAT,BIRSA,2,0,0,1,0,3
MADHYA PRADESH,BALAGHAT,KIRNAPUR,8,0,0,0,0,8
MADHYA PRADESH,BALAGHAT,LALBURRA,2,0,0,0,0,2
MADHYA PRADESH,BALAGHAT,LANJI,1,0,0,0,0,1
MADHYA PRADESH,BALAGHAT,WARASEONI,16,0,0,1,0,17
MADHYA PRADESH,BARWANI,BARWANI,182,2,198,3,12,397
MADHYA PRADESH,BARWANI,NIWALI,27,1,53,0,0,81
MADHYA PRADESH,BARWANI,PANSEMAL,1378,0,1,0,0,1379
MADHYA PRADESH,BARWANI,PATI,18,0,44,0,0,62
MADHYA PRADESH,BARWANI,RAJPUR,750,0,128,0,0,878
MADHYA PRADESH,BARWANI,SENDHWA,77,31,46,0,0,154
MADHYA PRADESH,BARWANI,THIKRI,557,1,346,0,0,904
MADHYA PRADESH,BETUL,AMLA,1125,60,7,2,3,1197
MADHYA PRADESH,BETUL,ATHNER,41,0,2,1,0,44
MADHYA PRADESH,BETUL,BETUL,1297,80,18,2,1,1398
MADHYA PRADESH,BETUL,BHAINSDEHI,47,0,0,2,0,49
MADHYA PRADESH,BETUL,BHIMPURA,2,0,0,0,0,2
MADHYA PRADESH,BETUL,CHICHOLI,13,0,0,0,0,13
MADHYA PRADESH,BETUL,GHODA DONGRI,413,23,11,3,2,452
MADHYA PRADESH,BETUL,MULTAI,209,0,2,7,13,231
MADHYA PRADESH,BETUL,PRABHAT PATTAN,240,1,1,1,1,244
MADHYA PRADESH,BETUL,SHAHPUR,11,0,0,0,0,11
MADHYA PRADESH,BHIND,ATER,174,115,31,81,491,892
MADHYA PRADESH,BHIND,BHIND,105,128,41,47,315,636
MADHYA PRADESH,BHIND,GOHAD,146,1,1,2,667,817
MADHYA PRADESH,BHIND,LAHAR,24,1,0,23,80,128
MADHYA PRADESH,BHIND,MEHAGOAN,280,1,1,0,542,824
MADHYA PRADESH,BHIND,ROUN(MIHONA),46,0,0,0,229,275
MADHYA PRADESH,BHOPAL,BERASIA,34,0,0,0,0,34
MADHYA PRADESH,BHOPAL,FUNDA,128,1,0,0,1,130
MADHYA PRADESH,BURHANPUR,BURHANPUR,238,60,23,14,35,370
MADHYA PRADESH,BURHANPUR,KHAKNAR,289,0,16,39,27,371
MADHYA PRADESH,CHHATARPUR,BAXWAHA,1,0,0,0,0,1
MADHYA PRADESH,CHHATARPUR,CHHATARPUR,3,0,0,0,0,3
MADHYA PRADESH,CHHATARPUR,GOREHAR,2,0,0,0,0,2
MADHYA PRADESH,CHHATARPUR,VIJABAR,2,4,0,1,0,7
MADHYA PRADESH,CHHINDWARA,AMARWADA,73,108,26,61,65,333
MADHYA PRADESH,CHHINDWARA,BICHHUA,13,8,0,2,4,27
MADHYA PRADESH,CHHINDWARA,CHHINDWADA,212,81,90,183,352,918
MADHYA PRADESH,CHHINDWARA,CHOURAI,157,18,49,70,523,817
MADHYA PRADESH,CHHINDWARA,HARAI,36,5,11,15,68,135
MADHYA PRADESH,CHHINDWARA,JAMAI,69,96,80,71,81,397
MADHYA PRADESH,CHHINDWARA,MOHKHED,138,9,32,99,134,412
MADHYA PRADESH,CHHINDWARA,PANDHURANA,113,60,119,83,124,499
MADHYA PRADESH,CHHINDWARA,PARASIA,44,177,283,225,293,1022
MADHYA PRADESH,CHHINDWARA,SAUSAR,2,2,5,2,3,14
MADHYA PRADESH,DAMOH,BATIYAGHARH,1265,0,0,0,1,1266
MADHYA PRADESH,DAMOH,DAMOH,40,0,0,0,0,40
MADHYA PRADESH,DAMOH,HATTA,506,0,0,0,0,506
MADHYA PRADESH,DAMOH,JABERA,3,0,0,0,0,3
MADHYA PRADESH,DAMOH,PATERA,2,0,0,0,0,2
MADHYA PRADESH,DAMOH,PATHARIA,1148,0,0,0,0,1148
MADHYA PRADESH,DAMOH,TENDUKHEDA,1,0,0,0,0,1
MADHYA PRADESH,DATIA,BHANDER,191,0,0,0,50,241
MADHYA PRADESH,DATIA,DATIA,45,0,0,0,6,51
MADHYA PRADESH,DATIA,SEONDHA,70,30,2,0,2,104
MADHYA PRADESH,DEWAS,BAGLEE,1131,19,0,0,208,1358
MADHYA PRADESH,DEWAS,DEWAS,4579,86,11,1,114,4791
MADHYA PRADESH,DEWAS,KANNOD,114,8,9,0,3,134
MADHYA PRADESH,DEWAS,KHATEGAON,139,0,0,1,0,140
MADHYA PRADESH,DEWAS,SONKUCH,1832,163,4,107,10,2116
MADHYA PRADESH,DEWAS,TONKHURD,1560,13,3,44,30,1650
MADHYA PRADESH,DHAR,BADNAWER,124,0,0,17,0,141
MADHYA PRADESH,DHAR,BAGH,28,2,0,0,0,30
MADHYA PRADESH,DHAR,DAHI,117,0,0,0,1,118
MADHYA PRADESH,DHAR,DHAR,12,0,0,0,0,12
MADHYA PRADESH,DHAR,DHARAMPURI,168,0,0,0,0,168
MADHYA PRADESH,DHAR,KUKSHI,49,0,0,0,0,49
MADHYA PRADESH,DHAR,MANAWAR,53,1,0,0,0,54
MADHYA PRADESH,DHAR,NISARPUR,30,0,0,0,0,30
MADHYA PRADESH,DHAR,SARDARPUR,224,0,0,0,0,224
MADHYA PRADESH,DHAR,TIRLA,51,0,0,1,90,142
MADHYA PRADESH,DHAR,UMARBAN,2,1,0,0,0,3
MADHYA PRADESH,GUNA,ARON,1939,0,0,0,15,1954
MADHYA PRADESH,GUNA,BAMORI,2423,0,0,0,12,2435
MADHYA PRADESH,GUNA,CHANCHODA,265,0,0,0,0,265
MADHYA PRADESH,GUNA,GUNA,2422,0,49,1,24,2496
MADHYA PRADESH,GUNA,RAGHOGARH,126,0,7,0,0,133
MADHYA PRADESH,GWALIOR,BHITARWAR,775,21,0,0,2,798
MADHYA PRADESH,GWALIOR,DABRA,1412,0,8,18,84,1522
MADHYA PRADESH,GWALIOR,GHATIGAWAN,1467,40,21,19,129,1676
MADHYA PRADESH,GWALIOR,MORAR,772,65,143,39,6,1025
MADHYA PRADESH,HARDA,HARDA,0,142,0,0,3,145
MADHYA PRADESH,HARDA,KHIRKIYA,54,448,1,24,19,546
MADHYA PRADESH,HARDA,TIMARNI,86,152,19,3,1,261
MADHYA PRADESH,HOSHANGABAD,BABAI,198,0,1,11,15,225
MADHYA PRADESH,HOSHANGABAD,BANKHEDI,82,0,1,0,1,84
MADHYA PRADESH,HOSHANGABAD,HOSHANGABAD,57,0,0,0,0,57
MADHYA PRADESH,HOSHANGABAD,KESLA,0,0,2,0,0,2
MADHYA PRADESH,HOSHANGABAD,PIPARIYA,4,0,0,0,1,5
MADHYA PRADESH,HOSHANGABAD,SEONIMALWA,28,0,14,2,0,44
MADHYA PRADESH,HOSHANGABAD,SOHAGPUR,144,2,1,0,0,147
MADHYA PRADESH,INDORE,DEPAL PUR,0,1,0,0,5,6
MADHYA PRADESH,INDORE,INDORE,5,0,0,1,0,6
MADHYA PRADESH,INDORE,MHOW,39,0,1,0,1,41
MADHYA PRADESH,INDORE,SANWER,65,0,0,0,0,65
MADHYA PRADESH,JABALPUR,BARGI,287,0,0,0,0,287
MADHYA PRADESH,JABALPUR,KUNDAM,50,0,0,0,1,51
MADHYA PRADESH,JABALPUR,MAJHOLI,1248,0,1,1,3,1253
MADHYA PRADESH,JABALPUR,PANAGAR,28,0,0,0,1,29
MADHYA PRADESH,JABALPUR,PATAN,958,0,0,0,0,958
MADHYA PRADESH,JABALPUR,SHAHPURA,801,0,0,0,1,802
MADHYA PRADESH,JABALPUR,SIHORA,166,0,0,0,0,166
MADHYA PRADESH,JHABUA,JOBAT,4,1,0,0,0,5
MADHYA PRADESH,JHABUA,MEGHNAGAR,20,0,0,0,0,20
MADHYA PRADESH,JHABUA,PETLAWAD,12,15,0,0,0,27
MADHYA PRADESH,JHABUA,RAMA,9,0,0,0,0,9
MADHYA PRADESH,JHABUA,SONDWA,24,3,2,0,0,29
MADHYA PRADESH,JHABUA,THANDLA,47,0,0,0,0,47
MADHYA PRADESH,KATNI,BADWARA,46,0,0,0,0,46
MADHYA PRADESH,KATNI,BAHORIBAND,118,0,0,1,0,119
MADHYA PRADESH,KATNI,DHIMAR KHERA,71,6,3,0,0,80
MADHYA PRADESH,KATNI,KATNI,57,6,1,1,1,66
MADHYA PRADESH,KATNI,RITHI,45,0,0,0,0,45
MADHYA PRADESH,KATNI,VIJAYRAGHAVGARH,4,0,0,0,0,4
MADHYA PRADESH,KHANDWA,BALADI,148,12,97,66,4,327
MADHYA PRADESH,KHANDWA,CHHEGAON MAKHAN,165,13,84,11,59,332
MADHYA PRADESH,KHANDWA,HARSOOD,95,4,79,28,17,223
MADHYA PRADESH,KHANDWA,KHALWA,130,7,92,31,29,289
MADHYA PRADESH,KHANDWA,KHANDWA,203,6,37,79,2,327
MADHYA PRADESH,KHANDWA,PANDHANA,271,5,74,33,10,393
MADHYA PRADESH,KHANDWA,PUNASA,119,17,39,78,19,272
MADHYA PRADESH,KHARGONE,BARWAHA,680,38,279,116,76,1189
MADHYA PRADESH,KHARGONE,BHAGWANPURA,49,2,2,9,3,65
MADHYA PRADESH,KHARGONE,BHIKANGAON,70,4,25,0,0,99
MADHYA PRADESH,KHARGONE,GOGAWA,106,0,0,1,15,122
MADHYA PRADESH,KHARGONE,KASRAWAD,81,9,228,77,46,441
MADHYA PRADESH,KHARGONE,KHARGONE,137,23,53,78,35,326
MADHYA PRADESH,KHARGONE,MAHESHWAR,117,0,18,11,24,170
MADHYA PRADESH,KHARGONE,SEGOAN,116,0,0,0,1,117
MADHYA PRADESH,KHARGONE,ZIRNYA,13,0,1,7,17,38
MADHYA PRADESH,MANDLA,BICHHIA,53,0,0,0,0,53
MADHYA PRADESH,MANDLA,MOHGAON,32,0,0,0,0,32
MADHYA PRADESH,MANDLA,NARAYANGANJ,3,0,0,0,0,3
MADHYA PRADESH,MANDSAUR,BHANPURA,22,0,21,2,4,49
MADHYA PRADESH,MANDSAUR,GAROTH,10,8,2,0,0,20
MADHYA PRADESH,MANDSAUR,MALHARGAR,32,0,0,0,0,32
MADHYA PRADESH,MANDSAUR,MANDSAUR,28,2,1,0,2,33
MADHYA PRADESH,MANDSAUR,SITAMAU,39,2,0,0,0,41
MADHYA PRADESH,MORENA,AMBAH,364,1,0,0,1,366
MADHYA PRADESH,MORENA,JAURA,66,0,5,0,0,71
MADHYA PRADESH,MORENA,KAILARAS,18,0,0,0,0,18
MADHYA PRADESH,MORENA,MORENA,513,2,1,0,1,517
MADHYA PRADESH,MORENA,PAHADGARH,18,0,0,0,0,18
MADHYA PRADESH,MORENA,PORSA,279,0,0,0,1,280
MADHYA PRADESH,MORENA,SABALGARH,91,0,0,0,1,92
MADHYA PRADESH,NARSINGHPUR,BABAI-CHICHLI,38,0,1,0,1,40
MADHYA PRADESH,NARSINGHPUR,CHAVARPATHA,2,2,0,0,0,4
MADHYA PRADESH,NARSINGHPUR,GOTEGAON,90,0,0,21,0,111
MADHYA PRADESH,NARSINGHPUR,KARELI,1,0,0,0,0,1
MADHYA PRADESH,NARSINGHPUR,NARSINGHPUR,48,25,24,0,1,98
MADHYA PRADESH,NARSINGHPUR,SAIKHEDA,23,0,0,3,0,26
MADHYA PRADESH,NEEMUCH,JAWAD,1221,18,39,111,61,1450
MADHYA PRADESH,NEEMUCH,MANASA,79,2,0,0,129,210
MADHYA PRADESH,NEEMUCH,NEEMUCH,455,8,6,55,73,597
MADHYA PRADESH,PANNA,AJAYGARH,7,0,0,0,0,7
MADHYA PRADESH,PANNA,GUNOUR,2079,20,16,33,18,2166
MADHYA PRADESH,PANNA,PANNA,822,34,20,7,7,890
MADHYA PRADESH,PANNA,PAWAI,138,0,0,0,0,138
MADHYA PRADESH,PANNA,SHAHNAGAR,27,0,0,0,0,27
MADHYA PRADESH,RAISEN,ABDULLA GANJ,501,0,0,0,0,501
MADHYA PRADESH,RAISEN,BADI,9,0,0,0,0,9
MADHYA PRADESH,RAISEN,BEGAMGANJ,72,0,0,0,1,73
MADHYA PRADESH,RAISEN,SANCHI,854,1,0,0,48,903
MADHYA PRADESH,RAISEN,SILVANI,121,0,0,0,9,130
MADHYA PRADESH,RAISEN,UDAYPURA,86,0,0,1,0,87
MADHYA PRADESH,RAJGARH,BIAORA,62,1,1,0,0,64
MADHYA PRADESH,RAJGARH,KHILCHIPUR,10,0,7,0,0,17
MADHYA PRADESH,RAJGARH,NARSINGHGARH,573,0,63,3,332,971
MADHYA PRADESH,RAJGARH,RAJGARH,57,8,1,23,52,141
MADHYA PRADESH,RAJGARH,SARANGPUR,574,5,1,17,146,743
MADHYA PRADESH,RAJGARH,ZIRAPUR,12,2,5,0,0,19
MADHYA PRADESH,RATLAM,ALOT,692,268,14,2,1,977
MADHYA PRADESH,RATLAM,BAJNA,32,1,9,1,8,51
MADHYA PRADESH,RATLAM,JAORA,254,124,62,113,182,735
MADHYA PRADESH,RATLAM,PIPLODA,209,192,97,168,190,856
MADHYA PRADESH,RATLAM,RATLAM,4054,272,64,1416,35,5841
MADHYA PRADESH,RATLAM,SAILANA,97,51,10,19,2,179
MADHYA PRADESH,REWA,GANGEO,89,1451,0,3,0,1543
MADHYA PRADESH,REWA,HANUMANA,1,33,0,0,0,34
MADHYA PRADESH,REWA,JAWA,2,5,0,0,0,7
MADHYA PRADESH,REWA,MAUGANJ,2,691,2,3,1,699
MADHYA PRADESH,REWA,NAIGARHI,74,571,0,0,0,645
MADHYA PRADESH,REWA,RAIPUR KARCULIYAN,78,2484,1,1,2,2566
MADHYA PRADESH,REWA,REWA,28,2723,2,80,1,2834
MADHYA PRADESH,REWA,SIRMOUR,244,1341,3,0,0,1588
MADHYA PRADESH,REWA,TEONTHER,1082,18,1,0,0,1101
MADHYA PRADESH,SAGAR,JAISINAGAR,78,2,1,0,0,81
MADHYA PRADESH,SAGAR,KHURAI,50,3,14,33,105,205
MADHYA PRADESH,SAGAR,MALTHONE,3,0,0,0,0,3
MADHYA PRADESH,SAGAR,RAHATGARH,0,0,0,0,1,1
MADHYA PRADESH,SAGAR,REHALI/GARHAKOTA,482,122,3,233,567,1407
MADHYA PRADESH,SAGAR,SAGAR,25,0,0,1,0,26
MADHYA PRADESH,SATNA,AMARPATAN,1390,0,34,12,0,1436
MADHYA PRADESH,SATNA,MAIHAR,694,14,13,2,1,724
MADHYA PRADESH,SATNA,MAJHAGAWAN,158,0,10,0,0,168
MADHYA PRADESH,SATNA,NAGOD,1629,0,9,0,0,1638
MADHYA PRADESH,SATNA,RAMNAGER,226,1,0,0,0,227
MADHYA PRADESH,SATNA,RAMPUR BAGHELAN,2324,35,20,5,0,2384
MADHYA PRADESH,SATNA,SOHAWAL,2523,75,2,71,3,2674
MADHYA PRADESH,SATNA,UCHEHARA,344,8,5,13,1,371
MADHYA PRADESH,SEHORE,ASHTA,739,2,78,0,2,821
MADHYA PRADESH,SEHORE,BUDHNI,195,0,0,0,0,195
MADHYA PRADESH,SEHORE,ICHAWAR,212,1,36,0,0,249
MADHYA PRADESH,SEHORE,NASRULLAGANJ,407,2,0,0,3,412
MADHYA PRADESH,SEHORE,SEHORE,186,0,0,0,0,186
MADHYA PRADESH,SEONI,CHHAPARA,6,0,0,0,0,6
MADHYA PRADESH,SEONI,DHANORA,1,1,0,0,0,2
MADHYA PRADESH,SEONI,KEOLARI,1,0,0,0,0,1
MADHYA PRADESH,SEONI,KURAI,23,18,5,7,3,56
MADHYA PRADESH,SEONI,LAKHNADON,100,4,1,3,0,108
MADHYA PRADESH,SEONI,SEONI,119,10,3,3,1,136
MADHYA PRADESH,SHAHDOL,BEOHARI,3,64,0,0,0,67
MADHYA PRADESH,SHAHDOL,BURHAR,1,1,0,0,0,2
MADHYA PRADESH,SHAHDOL,GOHAPARU,0,10,0,0,0,10
MADHYA PRADESH,SHAHDOL,JAISINGHNAGAR,6,16,1,0,0,23
MADHYA PRADESH,SHAHDOL,SOHAGPUR,16,79,0,0,2,97
MADHYA PRADESH,SHAJAPUR,AGAR,43,25,22,3,3,96
MADHYA PRADESH,SHAJAPUR,BAROD,101,38,16,9,5,169
MADHYA PRADESH,SHAJAPUR,KALAPIPAL,202,50,0,0,2,254
MADHYA PRADESH,SHAJAPUR,M.BARODIYA,1199,81,48,36,10,1374
MADHYA PRADESH,SHAJAPUR,NALKHEDA,33,0,0,1,0,34
MADHYA PRADESH,SHAJAPUR,SHAJAPUR,48,0,8,6,2,64
MADHYA PRADESH,SHAJAPUR,SHUJALPUR,31,0,0,0,0,31
MADHYA PRADESH,SHAJAPUR,SUSNER,1,0,0,0,0,1
MADHYA PRADESH,SHEOPUR,KARHAL,425,122,74,21,74,716
MADHYA PRADESH,SHEOPUR,SHEOPUR,1748,1146,6,26,175,3101
MADHYA PRADESH,SHEOPUR,VIJAYPUR,836,134,4,43,60,1077
MADHYA PRADESH,SHIVPURI,BADARWAS,671,0,0,1,1,673
MADHYA PRADESH,SHIVPURI,KARERA,4,0,0,0,0,4
MADHYA PRADESH,SHIVPURI,KHANIYADHANA,4,0,0,0,0,4
MADHYA PRADESH,SHIVPURI,KOLARAS,346,0,0,0,1,347
MADHYA PRADESH,SHIVPURI,NARWAR,6,0,0,0,0,6
MADHYA PRADESH,SHIVPURI,PICHHORE,5,0,0,0,0,5
MADHYA PRADESH,SHIVPURI,POHARI,706,6,1,3,13,729
MADHYA PRADESH,SHIVPURI,SHIVPURI,1367,0,1,158,1348,2874
MADHYA PRADESH,SIDHI,CHITRANGI,16,0,1,2,0,19
MADHYA PRADESH,SIDHI,DEOSAR,4,0,5,2,0,11
MADHYA PRADESH,SIDHI,MAJHOULI,26,12,13,4,0,55
MADHYA PRADESH,SIDHI,RAMPUR NAKIN,416,2,55,14,1,488
MADHYA PRADESH,SIDHI,SIDHI,11,1,5,19,2,38
MADHYA PRADESH,SIDHI,SIHAWAL,381,13,314,74,13,795
MADHYA PRADESH,SIDHI,WAIDHAN,39,0,16,25,5,85
MADHYA PRADESH,TIKAMGARH,BALDEVGARH,4,0,0,0,0,4
MADHYA PRADESH,TIKAMGARH,JATARA,7,0,0,0,0,7
MADHYA PRADESH,TIKAMGARH,NIWARI,2,0,0,0,0,2
MADHYA PRADESH,TIKAMGARH,PRATHVIPUR,3,0,0,0,0,3
MADHYA PRADESH,TIKAMGARH,TIKAMGARH,21,0,0,0,0,21
MADHYA PRADESH,UJJAIN,GHATTIA,0,0,2,0,0,2
MADHYA PRADESH,UJJAIN,KHACHROD,14,0,27,0,0,41
MADHYA PRADESH,UJJAIN,MEHIDPUR,0,0,23,0,0,23
MADHYA PRADESH,UJJAIN,TARANA,47,0,0,0,0,47
MADHYA PRADESH,UJJAIN,UJJAIN,209,0,0,0,0,209
MADHYA PRADESH,UMARIA,KARKELI,36,0,0,0,0,36
MADHYA PRADESH,UMARIA,MANPUR,371,9,0,70,3,453
MADHYA PRADESH,UMARIA,PALI,7,0,2,0,0,9
MADHYA PRADESH,VIDISHA,BASODA,213,0,1,1,0,215
MADHYA PRADESH,VIDISHA,GYARASPUR,43,0,0,0,0,43
MADHYA PRADESH,VIDISHA,KURWAI,1122,0,0,0,10,1132
MADHYA PRADESH,VIDISHA,LATERI,1035,12,4,0,2,1053
MADHYA PRADESH,VIDISHA,NATERAN,292,3,0,0,0,295
MADHYA PRADESH,VIDISHA,SIRONJ,10,0,0,0,0,10
MADHYA PRADESH,VIDISHA,VIDISHA,512,0,0,0,0,512
MAHARASHTRA,AHMEDNAGAR,AKOLA,68,34,0,3,12,117
MAHARASHTRA,AHMEDNAGAR,JAMKHED,2,0,0,0,0,2
MAHARASHTRA,AHMEDNAGAR,KARJAT,270,14,0,2,2,288
MAHARASHTRA,AHMEDNAGAR,KOPARGAON,67,15,20,8,56,166
MAHARASHTRA,AHMEDNAGAR,NAGAR,410,280,58,25,17,790
MAHARASHTRA,AHMEDNAGAR,NEVASA,497,88,20,4,4,613
MAHARASHTRA,AHMEDNAGAR,PARNER,158,120,14,10,0,302
MAHARASHTRA,AHMEDNAGAR,PATHARDI,65,6,6,9,42,128
MAHARASHTRA,AHMEDNAGAR,RAHATA,689,205,5,0,4,903
MAHARASHTRA,AHMEDNAGAR,RAHURI,215,9,0,0,0,224
MAHARASHTRA,AHMEDNAGAR,SANGAMNER,85,92,10,2,6,195
MAHARASHTRA,AHMEDNAGAR,SHEVGAON,24,13,23,0,1,61
MAHARASHTRA,AHMEDNAGAR,SHRIGONDA,16,0,0,0,5,21
MAHARASHTRA,AHMEDNAGAR,SHRIRAMPUR,1227,286,83,3,1,1600
MAHARASHTRA,AKOLA,AKOLA,0,27,1,0,5,33
MAHARASHTRA,AKOLA,AKOT,4,0,0,0,0,4
MAHARASHTRA,AKOLA,BALAPUR,32,29,14,3,0,78
MAHARASHTRA,AKOLA,BARSHI TAKLI,1,0,0,0,0,1
MAHARASHTRA,AKOLA,MURTIJAPUR,0,3,0,0,0,3
MAHARASHTRA,AKOLA,PATUR,1,0,0,0,0,1
MAHARASHTRA,AKOLA,TELHARA,7,0,0,0,1,8
MAHARASHTRA,AMRAVATI,ACHALPUR,56,0,0,0,0,56
MAHARASHTRA,AMRAVATI,AMRAVATI,1,2,1,4,7,15
MAHARASHTRA,AMRAVATI,ANJANGAON SURJI,5,0,0,0,0,5
MAHARASHTRA,AMRAVATI,CHANDUR BAZAR,23,0,0,0,0,23
MAHARASHTRA,AMRAVATI,CHANDUR RAILWAY,10,0,0,0,0,10
MAHARASHTRA,AMRAVATI,CHIKHALDARA,5,1,0,0,2,8
MAHARASHTRA,AMRAVATI,DHAMANGAON RAILWAY,2,0,0,0,0,2
MAHARASHTRA,AMRAVATI,DHARNI,11,6,2,3,1,23
MAHARASHTRA,AMRAVATI,MORSHI,99,1,0,0,0,100
MAHARASHTRA,AMRAVATI,WARUD,388,0,0,0,4,392
MAHARASHTRA,AURANGABAD,AURANGABAD,46,1,0,0,0,47
MAHARASHTRA,AURANGABAD,FULAMBRI,30,1,0,0,0,31
MAHARASHTRA,AURANGABAD,GANAGAPUR,50,0,0,0,0,50
MAHARASHTRA,AURANGABAD,KANNAD,41,2,4,0,0,47
MAHARASHTRA,AURANGABAD,KHULDABAD,26,0,0,0,0,26
MAHARASHTRA,AURANGABAD,PAITHAN,406,10,1,0,4,421
MAHARASHTRA,AURANGABAD,SILLOD,16,0,0,0,0,16
MAHARASHTRA,AURANGABAD,SOEGAON,34,0,1,0,0,35
MAHARASHTRA,AURANGABAD,VAIJAPUR,76,7,3,0,0,86
MAHARASHTRA,BEED,AMBEJOGAI,144,404,330,723,5,1606
MAHARASHTRA,BEED,ASHTI,510,388,375,36,2,1311
MAHARASHTRA,BEED,DHARUR,6,0,0,0,0,6
MAHARASHTRA,BEED,GEORAI,31,11,0,0,0,42
MAHARASHTRA,BEED,KAIJ,279,816,362,139,18,1614
MAHARASHTRA,BEED,MAJALGAON,80,58,339,12,2,491
MAHARASHTRA,BEED,PARLI,86,157,448,4,0,695
MAHARASHTRA,BEED,PATODA,102,92,16,2,29,241
MAHARASHTRA,BEED,SHIRUR (KASAR),30,3,0,0,0,33
MAHARASHTRA,BHANDARA,LAKHANDUR,2,0,0,0,0,2
MAHARASHTRA,BHANDARA,SAKOLI,3,2,2,7,11,25
MAHARASHTRA,BHANDARA,TUMSAR,2,0,0,0,0,2
MAHARASHTRA,BULDANA,BULDANA,0,1,0,0,0,1
MAHARASHTRA,BULDANA,CHIKHLI,0,83,3,19,0,105
MAHARASHTRA,BULDANA,DEULGAON RAJA,1,0,0,0,0,1
MAHARASHTRA,BULDANA,KHAMGAON,16,0,0,0,0,16
MAHARASHTRA,BULDANA,MALKAPUR,0,8,4,8,10,30
MAHARASHTRA,BULDANA,MEHKAR,47,10,1,1,1,60
MAHARASHTRA,BULDANA,MOTALA,59,4,5,14,4,86
MAHARASHTRA,BULDANA,NANDURA,115,63,1,0,2,181
MAHARASHTRA,BULDANA,SHEGAON,4,15,2,0,0,21
MAHARASHTRA,CHANDRAPUR,BHADRAVATI,74,0,0,2,8,84
MAHARASHTRA,CHANDRAPUR,CHANDRAPUR,1,1,0,0,0,2
MAHARASHTRA,CHANDRAPUR,CHIMUR,2,0,0,0,3,5
MAHARASHTRA,CHANDRAPUR,KORPANA,7,3,0,0,0,10
MAHARASHTRA,CHANDRAPUR,NAGBHIR,0,1,0,0,0,1
MAHARASHTRA,CHANDRAPUR,RAJURA,1,0,0,0,0,1
MAHARASHTRA,CHANDRAPUR,SAWALI,2,0,1,0,0,3
MAHARASHTRA,CHANDRAPUR,SINDEWAHI,34,0,0,0,1,35
MAHARASHTRA,CHANDRAPUR,WARORA,27,6,3,0,8,44
MAHARASHTRA,DHULE,DHULE,22,0,0,0,0,22
MAHARASHTRA,DHULE,SAKRI,14,6,0,0,0,20
MAHARASHTRA,DHULE,SHIRPUR,4187,197,0,0,6,4390
MAHARASHTRA,DHULE,SINDKHEDA,436,289,128,19,23,895
MAHARASHTRA,GADCHIROLI,AHERI,12,0,0,0,0,12
MAHARASHTRA,GADCHIROLI,CHAMORSHI,0,0,0,0,5,5
MAHARASHTRA,GADCHIROLI,DHANORA,1,0,0,0,0,1
MAHARASHTRA,GADCHIROLI,ETTAPALLI,1,0,0,0,0,1
MAHARASHTRA,GADCHIROLI,KURKHEDA,2,0,0,0,0,2
MAHARASHTRA,GADCHIROLI,SIRONCHA,0,2,0,0,8,10
MAHARASHTRA,GONDIYA,AMGAON,0,1,1,0,12,14
MAHARASHTRA,GONDIYA,DEVRI,3,0,0,0,0,3
MAHARASHTRA,GONDIYA,GONDIYA,2,0,0,0,0,2
MAHARASHTRA,GONDIYA,GOREGAON,0,0,1,1,0,2
MAHARASHTRA,GONDIYA,SADAK ARJUNI,1,1,0,0,0,2
MAHARASHTRA,GONDIYA,SALEKASA,51,30,3,0,5,89
MAHARASHTRA,GONDIYA,TIRODA,1,1,0,0,0,2
MAHARASHTRA,HINGOLI,AUNDHA (NAGNATH),12,0,0,0,0,12
MAHARASHTRA,HINGOLI,BASMATH,18,1,0,0,0,19
MAHARASHTRA,HINGOLI,HINGOLI,40,0,0,0,0,40
MAHARASHTRA,HINGOLI,KALAMNURI,36,3,0,0,0,39
MAHARASHTRA,HINGOLI,SENGAON,147,80,3,0,0,230
MAHARASHTRA,JALGAON,AMALNER,47,71,17,18,26,179
MAHARASHTRA,JALGAON,BHUSAWAL,125,111,69,19,84,408
MAHARASHTRA,JALGAON,BODWAD,48,0,1,24,65,138
MAHARASHTRA,JALGAON,CHALISGAON,0,0,0,3,0,3
MAHARASHTRA,JALGAON,CHOPDA,467,993,732,340,64,2596
MAHARASHTRA,JALGAON,DHARANGAON,144,29,20,20,22,235
MAHARASHTRA,JALGAON,ERANDOL,2,2,1,0,0,5
MAHARASHTRA,JALGAON,JALGAON,641,850,197,20,49,1757
MAHARASHTRA,JALGAON,JAMNER,107,46,104,27,22,306
MAHARASHTRA,JALGAON,MUKTAINAGAR,106,44,33,229,82,494
MAHARASHTRA,JALGAON,PACHORA,30,3,0,0,0,33
MAHARASHTRA,JALGAON,PAROLA,4,3,2,2,6,17
MAHARASHTRA,JALGAON,RAVER,987,264,127,162,118,1658
MAHARASHTRA,JALGAON,YAWAL,354,429,29,108,22,942
MAHARASHTRA,JALNA,AMBAD,120,2,4,0,0,126
MAHARASHTRA,JALNA,BADNAPUR,34,0,0,0,0,34
MAHARASHTRA,JALNA,BHOKARDAN,57,0,0,0,0,57
MAHARASHTRA,JALNA,GHANSAWANGI,103,4,0,0,0,107
MAHARASHTRA,JALNA,JAFFERABAD,21,0,0,0,0,21
MAHARASHTRA,JALNA,JALNA,1,0,0,0,0,1
MAHARASHTRA,JALNA,MANTHA,38,0,0,0,0,38
MAHARASHTRA,JALNA,PARTUR,29,0,0,0,0,29
MAHARASHTRA,KOLHAPUR,AJRA,79,62,16,6,0,163
MAHARASHTRA,KOLHAPUR,BHUDARGAD,1,0,0,0,0,1
MAHARASHTRA,KOLHAPUR,CHANDGAD,28,27,0,1,5,61
MAHARASHTRA,KOLHAPUR,GADHINGLAJ,73,38,17,20,198,346
MAHARASHTRA,KOLHAPUR,HATKANANGALE,664,45,10,0,2,721
MAHARASHTRA,KOLHAPUR,KAGAL,21,17,0,18,2,58
MAHARASHTRA,KOLHAPUR,KARVIR,16,1,0,0,2,19
MAHARASHTRA,KOLHAPUR,PANHALA,15,2,1,1,1,20
MAHARASHTRA,KOLHAPUR,RADHANAGARI,43,61,0,0,0,104
MAHARASHTRA,KOLHAPUR,SHAHUWADI,16,8,0,0,0,24
MAHARASHTRA,KOLHAPUR,SHIROL,228,58,23,0,7,316
MAHARASHTRA,LATUR,AHMADPUR,113,62,52,3,4,234
MAHARASHTRA,LATUR,AUSA,877,299,890,294,69,2429
MAHARASHTRA,LATUR,CHAKUR,400,14,201,65,0,680
MAHARASHTRA,LATUR,DEONI,341,65,15,51,5,477
MAHARASHTRA,LATUR,JALKOT,41,1,0,10,1,53
MAHARASHTRA,LATUR,LATUR,912,315,914,339,102,2582
MAHARASHTRA,LATUR,NILANGA,2415,417,457,136,13,3438
MAHARASHTRA,LATUR,RENAPUR,205,718,379,242,20,1564
MAHARASHTRA,LATUR,SHIRUR ANANTPAL,733,940,69,6,2,1750
MAHARASHTRA,LATUR,UDGIR,168,77,129,38,7,419
MAHARASHTRA,NAGPUR,HINGNA,0,1,0,0,0,1
MAHARASHTRA,NAGPUR,KALAMESHWAR,1,0,0,0,3,4
MAHARASHTRA,NAGPUR,KAMPTEE,0,0,0,0,6,6
MAHARASHTRA,NAGPUR,KATOL,1,0,0,0,0,1
MAHARASHTRA,NAGPUR,KUHI,1,0,0,0,0,1
MAHARASHTRA,NAGPUR,NAGPUR RURAL,0,1,0,0,0,1
MAHARASHTRA,NAGPUR,NARKHED,0,0,0,1,3,4
MAHARASHTRA,NAGPUR,PARSEONI,0,0,1,0,0,1
MAHARASHTRA,NAGPUR,RAMTEK,0,1,0,0,0,1
MAHARASHTRA,NAGPUR,SAVNER,1,0,0,0,0,1
MAHARASHTRA,NANDED,ARDHAPUR,158,0,0,0,0,158
MAHARASHTRA,NANDED,BHOKAR,123,8,0,0,0,131
MAHARASHTRA,NANDED,BILOLI,58,0,0,0,0,58
MAHARASHTRA,NANDED,DEGLUR,116,6,0,0,0,122
MAHARASHTRA,NANDED,DHARMABAD,9,0,0,0,0,9
MAHARASHTRA,NANDED,HADGAON,11,0,0,0,0,11
MAHARASHTRA,NANDED,HIMAYATNAGAR,11,0,0,0,0,11
MAHARASHTRA,NANDED,KANDHAR,288,2,1,1,0,292
MAHARASHTRA,NANDED,KINWAT,40,0,0,0,4,44
MAHARASHTRA,NANDED,LOHA,323,19,1,0,35,378
MAHARASHTRA,NANDED,MAHOOR,41,2,0,0,0,43
MAHARASHTRA,NANDED,MUDKHED,13,0,0,0,0,13
MAHARASHTRA,NANDED,MUKHED,159,8,1,0,1,169
MAHARASHTRA,NANDED,NAIGAON (KHAIRGAON),32,0,0,0,1,33
MAHARASHTRA,NANDED,NANDED,207,2,0,0,0,209
MAHARASHTRA,NANDED,UMRI,64,0,0,0,0,64
MAHARASHTRA,NANDURBAR,AKKALKUWA,197,6,1,0,6,210
MAHARASHTRA,NANDURBAR,AKRANI,0,0,0,6,1,7
MAHARASHTRA,NANDURBAR,NANDURBAR,232,157,12,2,13,416
MAHARASHTRA,NANDURBAR,NAWAPUR,322,433,0,0,0,755
MAHARASHTRA,NANDURBAR,SHAHADE,1530,414,518,368,5,2835
MAHARASHTRA,NANDURBAR,TALODA,1337,0,0,0,1,1338
MAHARASHTRA,NASHIK,BAGLAN,13,0,0,0,35,48
MAHARASHTRA,NASHIK,CHANDWAD,1614,25,1,0,1,1641
MAHARASHTRA,NASHIK,DEOLA,6,0,0,0,0,6
MAHARASHTRA,NASHIK,DINDORI,465,0,0,0,0,465
MAHARASHTRA,NASHIK,IGATPURI,1368,0,0,0,0,1368
MAHARASHTRA,NASHIK,KALWAN,214,12,27,0,0,253
MAHARASHTRA,NASHIK,MALEGAON,115,0,0,0,0,115
MAHARASHTRA,NASHIK,NANDGAON,155,0,0,0,0,155
MAHARASHTRA,NASHIK,NASHIK,640,0,1,0,0,641
MAHARASHTRA,NASHIK,NIPHAD,2450,6,1,0,3,2460
MAHARASHTRA,NASHIK,PEINT,23,0,0,0,0,23
MAHARASHTRA,NASHIK,SINNAR,60,0,0,0,0,60
MAHARASHTRA,NASHIK,SURGANA,26,0,0,0,0,26
MAHARASHTRA,NASHIK,TRIMBAKESHWAR,111,0,0,0,0,111
MAHARASHTRA,NASHIK,YEOLA,88,0,0,0,0,88
MAHARASHTRA,OSMANABAD,BHOOM,110,82,23,161,2,378
MAHARASHTRA,OSMANABAD,KALAMB,265,475,1021,215,318,2294
MAHARASHTRA,OSMANABAD,LOHARA,167,340,374,36,1,918
MAHARASHTRA,OSMANABAD,OMARGA,94,302,561,231,87,1275
MAHARASHTRA,OSMANABAD,OSMANABAD,548,2057,2633,615,213,6066
MAHARASHTRA,OSMANABAD,PARANDA,87,32,3,0,0,122
MAHARASHTRA,OSMANABAD,TULJAPUR,364,441,420,258,42,1525
MAHARASHTRA,OSMANABAD,WASHI,301,612,587,259,8,1767
MAHARASHTRA,PARBHANI,GANGAKHED,20,0,0,0,0,20
MAHARASHTRA,PARBHANI,JINTUR,12,0,0,0,0,12
MAHARASHTRA,PARBHANI,MANWAT,11,0,1,0,0,12
MAHARASHTRA,PARBHANI,PALAM,41,0,0,0,0,41
MAHARASHTRA,PARBHANI,PARBHANI,1,0,0,0,0,1
MAHARASHTRA,PARBHANI,PURNA,16,0,0,0,0,16
MAHARASHTRA,PARBHANI,SAILU,64,0,1,0,0,65
MAHARASHTRA,PARBHANI,SONPETH,7,0,0,0,0,7
MAHARASHTRA,PUNE,AMBEGAON,31,4,0,0,0,35
MAHARASHTRA,PUNE,BARAMATI,330,0,19,89,1,439
MAHARASHTRA,PUNE,BHOR,10,0,0,0,0,10
MAHARASHTRA,PUNE,DAUND,93,0,0,0,0,93
MAHARASHTRA,PUNE,HAVELI,509,284,43,0,2,838
MAHARASHTRA,PUNE,INDAPUR,5,27,0,0,0,32
MAHARASHTRA,PUNE,JUNNAR,19,0,0,0,0,19
MAHARASHTRA,PUNE,MAWAL,79,34,0,3,1,117
MAHARASHTRA,PUNE,MULSHI,65,109,2,0,11,187
MAHARASHTRA,PUNE,PURANDHAR,96,0,0,0,0,96
MAHARASHTRA,PUNE,SHIRUR,0,99,21,4,239,363
MAHARASHTRA,RAIGHAR,ALIBAG,23,0,0,0,0,23
MAHARASHTRA,RAIGHAR,MANGOAN,11,0,0,0,0,11
MAHARASHTRA,RAIGHAR,MHASLA,16,0,0,0,0,16
MAHARASHTRA,RAIGHAR,PANVEL,3,0,0,0,0,3
MAHARASHTRA,RAIGHAR,POLADPUR,3,0,0,0,0,3
MAHARASHTRA,RAIGHAR,SHRIVARDHAN,10,0,0,0,0,10
MAHARASHTRA,RAIGHAR,SUDHAGAD,3,0,0,0,0,3
MAHARASHTRA,RAIGHAR,TALA,2,0,0,0,0,2
MAHARASHTRA,RATNAGIRI,KHED,1,1,0,0,0,2
MAHARASHTRA,RATNAGIRI,LANJA,2,0,0,0,0,2
MAHARASHTRA,RATNAGIRI,MANDANGAD,2,0,0,0,0,2
MAHARASHTRA,RATNAGIRI,SANGAMESHWAR,7,6,0,0,0,13
MAHARASHTRA,SANGLI,ATPADI,87,136,42,92,8,365
MAHARASHTRA,SANGLI,JAT,1545,934,251,96,63,2889
MAHARASHTRA,SANGLI,KADEGAON,168,247,78,108,91,692
MAHARASHTRA,SANGLI,KAVATHE-MAHANKLA,354,476,340,137,282,1589
MAHARASHTRA,SANGLI,KHANAPUR,533,761,120,40,7,1461
MAHARASHTRA,SANGLI,MIRAJ,1229,1313,475,119,39,3175
MAHARASHTRA,SANGLI,PALUS,384,12,0,0,2,398
MAHARASHTRA,SANGLI,SHIRALA,43,8,0,0,0,51
MAHARASHTRA,SANGLI,TASGAON,2144,2928,584,157,7,5820
MAHARASHTRA,SANGLI,WALWA,111,21,0,0,0,132
MAHARASHTRA,SATARA,JAOLI,16,0,0,0,0,16
MAHARASHTRA,SATARA,KARAD,122,23,32,12,7,196
MAHARASHTRA,SATARA,KHANDALA,11,21,2,0,7,41
MAHARASHTRA,SATARA,MAHABALESHWAR,2,17,1,0,1,21
MAHARASHTRA,SATARA,MAN,17,0,0,0,0,17
MAHARASHTRA,SATARA,PHALTAN,106,31,13,2,33,185
MAHARASHTRA,SATARA,SATARA,1,0,0,0,0,1
MAHARASHTRA,SATARA,WAI,200,26,9,0,0,235
MAHARASHTRA,SINDHUDURGA,DEVGAD,4,1,0,0,0,5
MAHARASHTRA,SINDHUDURGA,KANKAVLI,6,0,0,0,0,6
MAHARASHTRA,SINDHUDURGA,KUDAL,8,0,0,0,0,8
MAHARASHTRA,SINDHUDURGA,MALWAN,5,0,0,0,0,5
MAHARASHTRA,SINDHUDURGA,SAWANTWADI,1,0,0,0,0,1
MAHARASHTRA,SINDHUDURGA,VAIBHAVWADI,0,0,1,0,0,1
MAHARASHTRA,SOLAPUR,AKKALKOT,415,231,47,7,45,745
MAHARASHTRA,SOLAPUR,BARSHI,172,746,592,288,62,1860
MAHARASHTRA,SOLAPUR,KARMALA,508,1015,307,63,105,1998
MAHARASHTRA,SOLAPUR,MADHA,804,855,631,416,120,2826
MAHARASHTRA,SOLAPUR,MALSHIRAS,1015,300,377,103,98,1893
MAHARASHTRA,SOLAPUR,MANGALVEDHA,134,276,203,21,36,670
MAHARASHTRA,SOLAPUR,MOHOL,835,1331,370,384,17,2937
MAHARASHTRA,SOLAPUR,NORTH  SOLAPUR,107,133,92,34,6,372
MAHARASHTRA,SOLAPUR,PANDHARPUR,1517,1221,259,66,250,3313
MAHARASHTRA,SOLAPUR,SANGOLA,67,224,296,578,284,1449
MAHARASHTRA,SOLAPUR,SOUTH  SOLAPUR,406,483,171,211,11,1282
MAHARASHTRA,THANE,AMBERNATH,65,0,0,0,0,65
MAHARASHTRA,THANE,PALGHAR,2,0,0,0,0,2
MAHARASHTRA,THANE,SHAHAPUR,0,0,1,0,0,1
MAHARASHTRA,WARDHA,HINGANGHAT,0,0,0,0,8,8
MAHARASHTRA,WARDHA,SAMUDRAPUR,0,2,0,0,0,2
MAHARASHTRA,WARDHA,SELOO,0,2,0,0,0,2
MAHARASHTRA,WASHIM,KARANJA,70,33,31,7,17,158
MAHARASHTRA,WASHIM,MALEGAON,34,4,7,3,7,55
MAHARASHTRA,WASHIM,MANGRULPIR,10,8,3,1,3,25
MAHARASHTRA,WASHIM,MANORA,3,2,7,2,3,17
MAHARASHTRA,WASHIM,RISOD,72,28,87,16,36,239
MAHARASHTRA,WASHIM,WASHIM,35,2,47,14,33,131
MAHARASHTRA,YAVATMAL,DIGRAS,1,0,1,2,2,6
MAHARASHTRA,YAVATMAL,MAHAGAON,90,5,9,13,11,128
MAHARASHTRA,YAVATMAL,MAREGAON,9,2,2,0,0,13
MAHARASHTRA,YAVATMAL,UMARKHED,0,2,6,15,45,68
MAHARASHTRA,YAVATMAL,YAVATMAL,1,7,0,0,3,11
MAHARASHTRA,YAVATMAL,ZARI JAMANI,3,4,0,0,0,7
MEGHALAYA,WEST GARO HILLS,BETASING,2,0,0,0,0,2
MEGHALAYA,WEST GARO HILLS,TIKRIKILLA,2,0,0,0,0,2
MEGHALAYA,WEST GARO HILLS,ZIKZAK,1,0,0,0,0,1
NAGALAND,DIMAPUR,MEDZIPHEMA,0,2,0,0,0,2
ODISHA,ANGUL,ANUGUL,1,6,1,0,1,9
ODISHA,ANGUL,ATHAMALLIK,4,7,0,0,1,12
ODISHA,ANGUL,BANRAPALA,8,6,0,0,0,14
ODISHA,ANGUL,CHHENDIPADA,17,20,4,12,15,68
ODISHA,ANGUL,KANIHA,3,1,0,0,3,7
ODISHA,ANGUL,KISHOR NAGAR,11,4,0,1,0,16
ODISHA,ANGUL,PALALAHADA,0,1,0,0,1,2
ODISHA,BALASORE,BAHANAGA,10,72,42,95,18,237
ODISHA,BALASORE,BALASORE,75,56,19,31,13,194
ODISHA,BALASORE,BALIAPAL,15,47,41,18,9,130
ODISHA,BALASORE,BASTA,112,46,33,15,17,223
ODISHA,BALASORE,BHOGRAI,39,27,44,16,3,129
ODISHA,BALASORE,JALESWAR,31,110,30,39,15,225
ODISHA,BALASORE,KHAIRA,32,9,0,9,4,54
ODISHA,BALASORE,NILAGIRI,8,4,0,0,10,22
ODISHA,BALASORE,OUPADA,14,3,0,0,16,33
ODISHA,BALASORE,REMUNA,165,107,2,0,1,275
ODISHA,BALASORE,SIMULIA,14,2,8,2,0,26
ODISHA,BALASORE,SORO,116,61,0,0,0,177
ODISHA,BARGARH,AMBABHANA,47,16,1,0,0,64
ODISHA,BARGARH,BARAPALI,7,1,0,0,0,8
ODISHA,BARGARH,BARGARH,25,2,0,0,1,28
ODISHA,BARGARH,BHATALI,42,13,9,33,40,137
ODISHA,BARGARH,BHEDEN,3,0,0,0,0,3
ODISHA,BARGARH,JHARABANDH,14,2,0,0,0,16
ODISHA,BARGARH,PADMAPUR (RAJABUDASA,25,5,0,0,1,31
ODISHA,BARGARH,PAIKMAL,27,10,2,0,0,39
ODISHA,BARGARH,SOHELA,11,1,1,0,0,13
ODISHA,BHADRAK,BANTA,42,9,11,1,0,63
ODISHA,BHADRAK,BASUDEBPUR,27,40,42,1,0,110
ODISHA,BHADRAK,BHADRAK,36,32,9,2,1,80
ODISHA,BHADRAK,BHANDARI POKHARI,44,84,12,2,5,147
ODISHA,BHADRAK,CHANDABALI,6,0,0,0,6,12
ODISHA,BHADRAK,DHAMNAGAR,33,45,35,51,17,181
ODISHA,BHADRAK,TIHIDI,25,15,10,1,4,55
ODISHA,BOLANGIR,BELAPARA,2,0,0,0,1,3
ODISHA,BOLANGIR,DEOGAON,6,0,0,0,0,6
ODISHA,BOLANGIR,GUDVELA,6,0,0,0,0,6
ODISHA,BOLANGIR,KHAPRAKHOL,2,0,0,0,0,2
ODISHA,BOLANGIR,MURIBAHAL,2,0,0,0,0,2
ODISHA,BOLANGIR,PUINTALA,1,2,0,0,0,3
ODISHA,BOLANGIR,TITILAGARH,0,0,0,1,0,1
ODISHA,BOLANGIR,TUREIKELA,4,1,0,0,0,5
ODISHA,CUTTACK,BARANGA,3,1,1,3,2,10
ODISHA,CUTTACK,CUTTACKSADAR,93,27,2,0,0,122
ODISHA,CUTTACK,KANTAPADA,13,7,0,0,0,20
ODISHA,CUTTACK,MAHANGA,40,10,1,0,0,51
ODISHA,CUTTACK,NIALI,50,8,1,0,0,59
ODISHA,CUTTACK,NISCHINTAKOILI,51,1,3,7,17,79
ODISHA,CUTTACK,SALIPUR,9,3,1,0,0,13
ODISHA,DEOGARH,BARAKOTE,112,11,0,1,4,128
ODISHA,DEOGARH,RIAMAL,41,2,0,0,4,47
ODISHA,DEOGARH,TILEIBANI,22,4,0,1,0,27
ODISHA,DHENKANAL,GANDIA,1,0,0,1,0,2
ODISHA,DHENKANAL,HINDOL,1,0,0,0,0,1
ODISHA,DHENKANAL,KANKADAHAD,1,0,0,0,0,1
ODISHA,DHENKANAL,ODAPADA,3,1,0,0,2,6
ODISHA,DHENKANAL,SADAR,15,12,0,0,5,32
ODISHA,GAJAPATI,KASINAGAR,0,0,0,2,0,2
ODISHA,GAJAPATI,MOHANA,0,1,0,0,0,1
ODISHA,GANJAM,BELLAGUNTHA,6,2,0,0,0,8
ODISHA,GANJAM,BHANJANAGAR,11,0,0,0,0,11
ODISHA,GANJAM,CHHATRAPUR,11,6,3,0,0,20
ODISHA,GANJAM,CHIKETI,2,7,0,2,0,11
ODISHA,GANJAM,DHARAKOTE,3,0,0,0,0,3
ODISHA,GANJAM,DIGAPAHANDI,1,1,0,0,0,2
ODISHA,GANJAM,GANJAM,9,4,2,0,3,18
ODISHA,GANJAM,KHALLIKOTE,2,0,0,0,0,2
ODISHA,GANJAM,KODALA,1,0,0,0,0,1
ODISHA,GANJAM,KUKUDAHANDI,1,0,1,0,0,2
ODISHA,GANJAM,PATRAPUR,1,0,0,0,0,1
ODISHA,GANJAM,POLASARA,3,0,0,0,0,3
ODISHA,GANJAM,PURUSOTTAMPUR,4,1,1,0,0,6
ODISHA,GANJAM,RANGEILUNDA,0,1,0,0,0,1
ODISHA,GANJAM,SANAKHEMUNDI,6,1,1,0,1,9
ODISHA,GANJAM,SHERAGAD,2,5,17,3,1,28
ODISHA,JAGATSINGHPUR,BALIKUDA,13,5,5,0,0,23
ODISHA,JAGATSINGHPUR,BIRIDI,6,0,0,0,0,6
ODISHA,JAGATSINGHPUR,ERASAMA,2,2,0,0,3,7
ODISHA,JAGATSINGHPUR,JAGATSINGHPUR,12,6,1,0,0,19
ODISHA,JAGATSINGHPUR,KUJANG,3,0,0,1,5,9
ODISHA,JAGATSINGHPUR,NAUGAON,26,35,1,0,1,63
ODISHA,JAGATSINGHPUR,RAGHUNATHPUR,1,1,0,0,0,2
ODISHA,JAGATSINGHPUR,TIRTOL,161,8,0,1,1,171
ODISHA,JAJAPUR,BADACHANA,19,8,2,1,0,30
ODISHA,JAJAPUR,BARI,39,3,3,0,18,63
ODISHA,JAJAPUR,BINJHARPUR,24,11,20,2,3,60
ODISHA,JAJAPUR,DANAGADI,5,0,0,0,0,5
ODISHA,JAJAPUR,DASARATHPUR,38,24,10,0,0,72
ODISHA,JAJAPUR,DHARMASALA,68,10,1,0,2,81
ODISHA,JAJAPUR,JAJPUR,147,11,0,0,0,158
ODISHA,JAJAPUR,KOREI,165,1,0,0,0,166
ODISHA,JAJAPUR,RASULPUR,124,28,0,0,0,152
ODISHA,JAJAPUR,SUKINDA,30,0,1,9,1,41
ODISHA,JHARSUGUDA,JHARSUGUDA,2,0,0,0,0,2
ODISHA,JHARSUGUDA,KIRMIRA,0,1,0,0,0,1
ODISHA,JHARSUGUDA,KOLABIRA,0,0,0,0,1,1
ODISHA,JHARSUGUDA,LAKHANPUR,105,13,4,3,5,130
ODISHA,KALAHANDI,BHAWANIPATANA,2,0,0,0,0,2
ODISHA,KALAHANDI,DHARMGAD,1,0,0,0,0,1
ODISHA,KALAHANDI,JUNAGAD,2,1,0,0,1,4
ODISHA,KALAHANDI,KESINGA,1,0,0,0,0,1
ODISHA,KANDHAMAL,PHULBANI,0,1,0,0,0,1
ODISHA,KENDRAPARA,AUL,2,0,0,0,0,2
ODISHA,KENDRAPARA,DERABISHI,2,3,2,0,5,12
ODISHA,KENDRAPARA,GARADPUR,19,1,0,1,4,25
ODISHA,KENDRAPARA,KENDRAPADA,0,0,0,0,1,1
ODISHA,KENDRAPARA,MAHAKALPADA,5,1,0,0,0,6
ODISHA,KENDRAPARA,MARSHAGHAI,5,2,0,3,0,10
ODISHA,KENDRAPARA,PATTAMUNDAI,4,0,0,0,1,5
ODISHA,KENDRAPARA,RAJKANIKA,1,0,0,0,5,6
ODISHA,KENDRAPARA,RAJNAGAR,14,4,1,0,4,23
ODISHA,KEONJHAR,ANANDPUR,35,9,1,0,0,45
ODISHA,KEONJHAR,CHAMPUA,1,1,0,0,0,2
ODISHA,KEONJHAR,GHASIPURA,4,12,3,1,1,21
ODISHA,KEONJHAR,GHATAGAON,2,0,0,0,1,3
ODISHA,KEONJHAR,HATADIHI,27,17,4,0,1,49
ODISHA,KEONJHAR,JHUMPURA,3,0,0,0,0,3
ODISHA,KEONJHAR,PATANA,0,7,2,2,6,17
ODISHA,KEONJHAR,SAHARPADA,0,1,0,0,0,1
ODISHA,KHURDA,BALIANTA,6,31,0,0,0,37
ODISHA,KHURDA,BALIPATANA,9,1,2,0,0,12
ODISHA,KHURDA,BHUBANESWAR,2,2,0,0,0,4
ODISHA,KHURDA,CHILIKA,5,0,0,0,0,5
ODISHA,KHURDA,JATANI,5,0,0,0,0,5
ODISHA,KHURDA,KHURDA,1,0,0,0,0,1
ODISHA,KHURDA,TANGI,1,0,0,0,0,1
ODISHA,KORAPUT,BOIPARIGUDA,1,0,0,0,0,1
ODISHA,KORAPUT,BORIGUMMA,1,0,0,0,0,1
ODISHA,KORAPUT,JEYPORE,3,1,0,0,0,4
ODISHA,KORAPUT,KORAPUT,1,0,0,0,0,1
ODISHA,KORAPUT,KOTPAD,5,0,0,0,0,5
ODISHA,MALKANAGIRI,KORKONDA,1,0,0,0,1,2
ODISHA,MALKANAGIRI,MALKANGIRI,20,3,0,0,0,23
ODISHA,MAYURBHANJA,BADASAHI,30,38,1,0,5,74
ODISHA,MAYURBHANJA,BANGIRIPOSI,8,0,0,0,0,8
ODISHA,MAYURBHANJA,BARIPADA,1,0,1,1,1,4
ODISHA,MAYURBHANJA,BETANATI,24,38,7,4,12,85
ODISHA,MAYURBHANJA,BISOI,1,0,0,0,0,1
ODISHA,MAYURBHANJA,GOPABANDHUNAGAR,0,4,0,0,1,5
ODISHA,MAYURBHANJA,JASIPUR,1,2,0,0,0,3
ODISHA,MAYURBHANJA,KARANJIA,0,0,0,1,0,1
ODISHA,MAYURBHANJA,KHUNTA,4,17,0,0,0,21
ODISHA,MAYURBHANJA,KULIANA,4,3,5,0,1,13
ODISHA,MAYURBHANJA,KUSUMI,1,0,0,0,0,1
ODISHA,MAYURBHANJA,MURUDA,21,24,8,2,0,55
ODISHA,MAYURBHANJA,RASAGOBINDAPUR,77,17,6,4,8,112
ODISHA,MAYURBHANJA,SARASAKANA,3,4,0,0,1,8
ODISHA,MAYURBHANJA,SULIAPADA,50,10,2,0,1,63
ODISHA,NAWARANGAPUR,CHANDAHANDI,1,0,0,0,0,1
ODISHA,NAWARANGAPUR,JHARIGAON,1,0,0,0,1,2
ODISHA,NAWARANGAPUR,KOSAGUMUDA,4,0,0,0,0,4
ODISHA,NAWARANGAPUR,PAPADAHANDI,7,0,0,0,0,7
ODISHA,NAWARANGAPUR,RAIGHAR,9,1,0,0,12,22
ODISHA,NAWARANGAPUR,TENTULIKHUNTI,7,0,0,0,0,7
ODISHA,NAWARANGAPUR,UMARKOTE,5,0,1,0,0,6
ODISHA,NAYAGARH,KHANDAPARA,4,0,0,0,0,4
ODISHA,NAYAGARH,NAYAGARH,3,0,0,0,0,3
ODISHA,NAYAGARH,NUAGAON,0,1,0,0,0,1
ODISHA,NAYAGARH,ODAGAON,2,1,0,0,0,3
ODISHA,NUAPADA,BODEN,1,0,0,0,0,1
ODISHA,NUAPADA,NUAPADA,14,2,0,0,0,16
ODISHA,NUAPADA,SINAPALI,0,1,0,0,1,2
ODISHA,PURI,ASTARANG,1,0,0,0,0,1
ODISHA,PURI,BRAHMAGIRI,8,0,0,0,0,8
ODISHA,PURI,GOP,11,3,0,0,1,15
ODISHA,PURI,KAKATPUR,2,1,0,0,0,3
ODISHA,PURI,NIMAPARA,26,9,8,10,2,55
ODISHA,PURI,PIPILI,10,2,0,0,0,12
ODISHA,PURI,PURISADAR,5,2,0,0,0,7
ODISHA,PURI,SATYABADI,2,0,0,0,0,2
ODISHA,RAYAGADA,BISAMCUTTACK,10,0,0,0,0,10
ODISHA,RAYAGADA,GUDARI,2,0,0,4,0,6
ODISHA,RAYAGADA,KOLNARA,2,3,0,0,0,5
ODISHA,RAYAGADA,MUNIGUDA,0,0,0,0,1,1
ODISHA,RAYAGADA,RAYAGADA,4,1,0,0,0,5
ODISHA,SAMBALPUR,DHANAKOIDA(SAMBALPUR,1,0,0,0,0,1
ODISHA,SAMBALPUR,GOVINDAPUR,9,2,0,0,0,11
ODISHA,SAMBALPUR,JAMANKIRA,6,0,2,0,0,8
ODISHA,SAMBALPUR,JUJUMURA,0,1,0,0,2,3
ODISHA,SAMBALPUR,KUCHINDA,2,0,0,0,0,2
ODISHA,SAMBALPUR,MANESWAR,1,5,0,0,2,8
ODISHA,SAMBALPUR,RAIRAKHOLA,2,0,0,0,0,2
ODISHA,SAMBALPUR,RENGALI,6,0,0,9,0,15
ODISHA,SONEPUR,DUNGURIPALI,1,0,0,1,0,2
ODISHA,SONEPUR,SONEPUR,0,0,0,0,1,1
ODISHA,SONEPUR,TARAVA,1,0,1,0,0,2
ODISHA,SUNDARGARH,BADAGAON,2,0,0,0,0,2
ODISHA,SUNDARGARH,BONAI,2,0,0,0,0,2
ODISHA,SUNDARGARH,HEMAGIRI,4,4,2,2,4,16
ODISHA,SUNDARGARH,KUANRAMUNDA,1,2,0,0,0,3
ODISHA,SUNDARGARH,KUTRA,0,2,0,0,8,10
ODISHA,SUNDARGARH,LAHUNIPADA,5,1,0,0,0,6
ODISHA,SUNDARGARH,LATHIKATA,4,40,0,0,1,45
ODISHA,SUNDARGARH,LEPHRIPADA,6,2,2,2,3,15
ODISHA,SUNDARGARH,SUBDEGA,0,0,0,1,0,1
ODISHA,SUNDARGARH,SUNDARGARH,5,5,1,1,2,14
ODISHA,SUNDARGARH,TANGARPALI,3,1,0,0,0,4
PUDUCHERRY,PUDUCHERRY,ARIANKUPPAM,63,62,1,2,0,128
PUDUCHERRY,PUDUCHERRY,BAHOUR,212,187,55,111,64,629
PUDUCHERRY,PUDUCHERRY,MANNADIPET,315,26,16,21,27,405
PUDUCHERRY,PUDUCHERRY,NETTAPAKKAM,350,81,3,2,1,437
PUDUCHERRY,PUDUCHERRY,OULGARET,17,4,2,4,33,60
PUDUCHERRY,PUDUCHERRY,PUDUCHERRY,4,11,2,5,0,22
PUDUCHERRY,PUDUCHERRY,VILLIANUR,194,67,10,12,26,309
PUNJAB,AMRITSER,AJNALA,179,0,0,0,0,179
PUNJAB,AMRITSER,BABA BAKALA,2,0,0,0,0,2
PUNJAB,AMRITSER,CHOGAWAN,844,8,0,1,2,855
PUNJAB,AMRITSER,GANDIWIND,1274,5,0,0,0,1279
PUNJAB,AMRITSER,HARSHA CHINNA,23,0,0,0,0,23
PUNJAB,AMRITSER,JANDIALA GURU,85,0,0,0,1,86
PUNJAB,AMRITSER,MAJITHA,4,2,2,4,0,12
PUNJAB,AMRITSER,TARSIKA,3,0,0,0,0,3
PUNJAB,AMRITSER,VERKA,113,7,0,0,0,120
PUNJAB,BARNALA,BARNALA,2553,11011,1500,0,0,15064
PUNJAB,BARNALA,MEHALKALAN,2293,4713,0,0,0,7006
PUNJAB,BARNALA,SEHNA,1298,3055,0,0,0,4353
PUNJAB,BATHINDA,BATHINDA,18,1,0,0,0,19
PUNJAB,BATHINDA,MAUR,3,0,0,0,0,3
PUNJAB,BATHINDA,NATHANA,381,278,178,129,0,966
PUNJAB,BATHINDA,PHUL,832,643,336,129,0,1940
PUNJAB,BATHINDA,RAMPURA,745,1130,627,89,0,2591
PUNJAB,BATHINDA,SANGAT,0,7,0,0,0,7
PUNJAB,BATHINDA,TALWANDI SAHU,1,26,0,0,0,27
PUNJAB,FARIDKOT,FARIDKOT,183,362,368,194,45,1152
PUNJAB,FARIDKOT,KOTAKPURA,360,268,232,320,146,1326
PUNJAB,FATEHGARH SAHIB,AMLOH,2,0,0,0,0,2
PUNJAB,FATEHGARH SAHIB,BASSI PATHANA,258,148,0,0,0,406
PUNJAB,FATEHGARH SAHIB,SIRHIND,19,5,0,0,0,24
PUNJAB,FEROZEPUR,FAZILKA,4,12,0,0,0,16
PUNJAB,FEROZEPUR,FEROZEPUR,0,7,0,0,0,7
PUNJAB,FEROZEPUR,GHAL KHURAD,315,1308,199,15,97,1934
PUNJAB,FEROZEPUR,GURUHAR SAHAI,137,22,0,0,0,159
PUNJAB,FEROZEPUR,MAKHU,7,0,0,0,0,7
PUNJAB,FEROZEPUR,ZIRA,4311,3625,3510,63,6,11515
PUNJAB,GURDASPUR,BATALA,0,1,0,0,0,1
PUNJAB,GURDASPUR,DERA BABA NANAK,0,11,0,0,0,11
PUNJAB,GURDASPUR,DHARIWAL,14,42,0,0,0,56
PUNJAB,GURDASPUR,DHARKALAN,125,3,36,0,1,165
PUNJAB,GURDASPUR,DINANAGAR,1,0,0,0,0,1
PUNJAB,GURDASPUR,FATEHGARH CHURIAN,620,336,0,0,0,956
PUNJAB,GURDASPUR,GURDASPUR,2,0,0,0,0,2
PUNJAB,GURDASPUR,KALANOUR,1,0,0,0,0,1
PUNJAB,GURDASPUR,PATHANKOT,434,407,27,8,0,876
PUNJAB,GURDASPUR,QUADIAN,14,0,15,0,0,29
PUNJAB,GURDASPUR,SHRI HARGOBIND PUR,224,156,0,0,0,380
PUNJAB,HOSHIARPUR,BHUNGA,1431,1246,223,32,30,2962
PUNJAB,HOSHIARPUR,DASUYA,2,0,5,11,4,22
PUNJAB,HOSHIARPUR,GARHSHANKAR,3645,683,398,26,68,4820
PUNJAB,HOSHIARPUR,HAZIPUR,40,31,23,12,1,107
PUNJAB,HOSHIARPUR,HOSHIARPUR-I,840,2303,339,45,14,3541
PUNJAB,HOSHIARPUR,HOSHIARPUR 2,282,4004,367,44,15,4712
PUNJAB,HOSHIARPUR,MAHILPUR,1236,2214,204,30,72,3756
PUNJAB,HOSHIARPUR,MUKERIAN,0,1,0,0,1,2
PUNJAB,HOSHIARPUR,TALWARA,1,4,1,13,4,23
PUNJAB,HOSHIARPUR,TANDA,682,48,0,0,0,730
PUNJAB,JALANDHAR,ADAMPUR,591,4507,0,0,7,5105
PUNJAB,JALANDHAR,BHOGPUR,2944,3599,1,1,100,6645
PUNJAB,JALANDHAR,JALANDHAR EAST,72,0,0,0,0,72
PUNJAB,JALANDHAR,JALANDHAR WEST,2112,183,0,0,0,2295
PUNJAB,JALANDHAR,LOHTIAN KHAS,3229,56,0,0,6,3291
PUNJAB,JALANDHAR,NAKODER,4183,19,0,0,0,4202
PUNJAB,JALANDHAR,NOORMEHAL,13,0,0,0,0,13
PUNJAB,JALANDHAR,PHILLOR,725,559,0,0,0,1284
PUNJAB,JALANDHAR,RURKA KALAN,3248,1336,0,0,1,4585
PUNJAB,JALANDHAR,SHAHKOT,2794,33,0,0,0,2827
PUNJAB,KAPURTHALA,DHILLWAN,1264,124,1,0,1,1390
PUNJAB,KAPURTHALA,KAPURTHALA,35,85,1,1,1,123
PUNJAB,KAPURTHALA,NADALA,0,10,0,0,0,10
PUNJAB,KAPURTHALA,PHAGWARA,0,566,0,0,2,568
PUNJAB,KAPURTHALA,SULTANPUR,25,466,1,0,1,493
PUNJAB,LUDHIANA,DEHLON,1313,32,0,0,0,1345
PUNJAB,LUDHIANA,DORAHA,360,60,5,0,0,425
PUNJAB,LUDHIANA,JAGRAON,6663,681,0,1,0,7345
PUNJAB,LUDHIANA,KHANNA,1,0,0,0,0,1
PUNJAB,LUDHIANA,LUDHIANA,2134,12,0,0,0,2146
PUNJAB,LUDHIANA,MANGAT,59,0,0,0,0,59
PUNJAB,LUDHIANA,MASHIWARA,13,0,0,0,0,13
PUNJAB,LUDHIANA,PAKHOWAL,7872,939,1,0,2,8814
PUNJAB,LUDHIANA,SIDHWAN BET,9,0,0,2,0,11
PUNJAB,LUDHIANA,SUDHAR,7064,1096,1,1,0,8162
PUNJAB,MANSA,BHIKHI,635,527,21,142,55,1380
PUNJAB,MANSA,BUDHLADA,1154,923,39,19,53,2188
PUNJAB,MANSA,MANSA,5,2,1,0,2,10
PUNJAB,MANSA,SARDOOLGARH,652,363,0,0,2,1017
PUNJAB,MOGA,BAGHA PURANA,1081,1971,439,51,32,3574
PUNJAB,MOGA,KOT ISE KHAN,2075,3055,276,95,3347,8848
PUNJAB,MOGA,MOGA II,809,2001,1955,2811,600,8176
PUNJAB,MOGA,MOOGA-1,1758,3408,3048,1269,985,10468
PUNJAB,MOGA,NIHAL SINGH WALA,1419,8327,29,1037,2,10814
PUNJAB,MOHALI,DERABASSI,415,135,218,387,146,1301
PUNJAB,MOHALI,KHARAR,7,7,22,0,1,37
PUNJAB,MOHALI,MAJRI,455,536,222,26,9,1248
PUNJAB,MUKATSAR,GIDARBAHA,67,0,0,0,0,67
PUNJAB,MUKATSAR,LAMBI,6,16,120,0,1,143
PUNJAB,MUKATSAR,MALOUT,2,0,0,1,0,3
PUNJAB,MUKATSAR,MUKATSAR,7,0,0,0,0,7
PUNJAB,NAWANSHAHAR,AUR,1037,730,1,1,0,1769
PUNJAB,NAWANSHAHAR,BALACHOR,1075,325,0,0,6,1406
PUNJAB,NAWANSHAHAR,BANGA,2449,1158,0,0,2,3609
PUNJAB,NAWANSHAHAR,NAWANSHAHR,947,222,172,6,0,1347
PUNJAB,NAWANSHAHAR,SADOYA,930,153,19,16,4,1122
PUNJAB,PATIALA,BHUNARKHERI,161,18,0,0,0,179
PUNJAB,PATIALA,KANOR,243,411,262,177,10,1103
PUNJAB,PATIALA,NABHA,7,0,0,0,3,10
PUNJAB,PATIALA,PATIALA,211,36,0,0,0,247
PUNJAB,PATIALA,PATRAN,398,63,4,2,0,467
PUNJAB,PATIALA,RAJPURA,1671,889,198,380,22,3160
PUNJAB,PATIALA,SAMANA,69,0,0,0,0,69
PUNJAB,PATIALA,SANOR,2927,920,0,0,0,3847
PUNJAB,ROPAR,ANANDPUR SAHIB,15,6,4,0,1,26
PUNJAB,ROPAR,CHAMKAUR SAHIB,188,48,1,0,155,392
PUNJAB,ROPAR,MORINDA,38,44,4,0,0,86
PUNJAB,ROPAR,NOORPUR BEDI,2,20,0,1,0,23
PUNJAB,ROPAR,ROPAR,11,93,1,1,6,112
PUNJAB,SANGRUR,AHMADGARH,3584,7756,86,8,7,11441
PUNJAB,SANGRUR,ANDANA,1944,3757,1472,223,13,7409
PUNJAB,SANGRUR,BHAVANIGARH,11093,166,26,0,0,11285
PUNJAB,SANGRUR,DHURI,4838,2797,833,55,78,8601
PUNJAB,SANGRUR,LEHRAGAGA,930,5131,990,188,72,7311
PUNJAB,SANGRUR,MALERKOTLA,10882,2636,211,0,8,13737
PUNJAB,SANGRUR,SANGRUR,4064,6994,1018,39,5,12120
PUNJAB,SANGRUR,SHERPUR,1916,5807,630,84,77,8514
PUNJAB,SANGRUR,SUNAM,6152,13548,792,402,48,20942
PUNJAB,TARN TARAN,BHIKHIWIND,0,2733,0,0,1,2734
PUNJAB,TARN TARAN,CHOHLA SAHIB,0,4,0,0,0,4
PUNJAB,TARN TARAN,GANDIWIND,3645,119,27,0,5,3796
PUNJAB,TARN TARAN,KHDUR SAHIB,121,111,11,0,1,244
PUNJAB,TARN TARAN,NOUSHERA PONUA,284,104,24,0,0,412
PUNJAB,TARN TARAN,PATTI,0,62,260,97,1,420
PUNJAB,TARN TARAN,TARN TARAN,0,23,2,0,0,25
PUNJAB,TARN TARAN,VALTOHA,133,3355,125,0,0,3613
RAJASTHAN,AJMER,AJMER,126,21,13,14,2,176
RAJASTHAN,AJMER,BEAWAR,0,0,0,1,0,1
RAJASTHAN,AJMER,KISHANGARH,12,70,42,45,10,179
RAJASTHAN,AJMER,MASUDA,1,0,2,0,0,3
RAJASTHAN,AJMER,NASIRABAD,9,7,1,6,0,23
RAJASTHAN,AJMER,PISAGAON,14,17,34,20,9,94
RAJASTHAN,AJMER,SARWAD,0,0,0,2,1,3
RAJASTHAN,ALWAR,ALWAR,752,915,287,55,9,2018
RAJASTHAN,ALWAR,BANSUR,13,4,9,10,0,36
RAJASTHAN,ALWAR,BEHROR,263,787,483,196,113,1842
RAJASTHAN,ALWAR,KATHUMAR,32,25,21,18,16,112
RAJASTHAN,ALWAR,KISHANGARH BAAS,110,184,225,254,1,774
RAJASTHAN,ALWAR,KOTKASIM,137,98,4,4,0,243
RAJASTHAN,ALWAR,LAXMANGARH,291,352,685,572,24,1924
RAJASTHAN,ALWAR,MANDAWAR,657,13,36,41,15,762
RAJASTHAN,ALWAR,RAJGARH,4,143,55,7,3,212
RAJASTHAN,ALWAR,RAMGARH,325,214,213,117,16,885
RAJASTHAN,ALWAR,THANAGAZI,1,0,1,1,2,5
RAJASTHAN,ALWAR,TIJARA,103,254,234,220,1,812
RAJASTHAN,BANSWARA,BAGIDORA,178,55,22,24,6,285
RAJASTHAN,BANSWARA,BANSWARA,8,5,11,15,2,41
RAJASTHAN,BANSWARA,GADHI,2,11,17,10,0,40
RAJASTHAN,BANSWARA,GHATOL,1,1,1,1,0,4
RAJASTHAN,BANSWARA,KUSHALGARH,4,6,0,0,0,10
RAJASTHAN,BARAN,ANTA,1707,323,20,15,4,2069
RAJASTHAN,BARAN,ATRU,3398,308,16,20,6,3748
RAJASTHAN,BARAN,BARAN,1584,2350,468,40,50,4492
RAJASTHAN,BARAN,CHABRA,309,1260,16,22,2,1609
RAJASTHAN,BARAN,CHIPA BAROD,317,1056,276,86,4,1739
RAJASTHAN,BARAN,KISHANGANJ,909,779,301,116,100,2205
RAJASTHAN,BARAN,MANGROL,286,158,115,37,6,602
RAJASTHAN,BARAN,SHAHABAD,195,985,874,77,11,2142
RAJASTHAN,BARMER,BARMER,8,0,1,0,0,9
RAJASTHAN,BARMER,BAYTOO,64,3,161,4,1,233
RAJASTHAN,BARMER,CHOHATAN,0,0,1,1,0,2
RAJASTHAN,BARMER,GUDAMALANI,78,148,17,174,0,417
RAJASTHAN,BARMER,PACH PADRA,263,21,8,5,1,298
RAJASTHAN,BARMER,SHIV,8,403,347,239,8,1005
RAJASTHAN,BARMER,SIWANA,251,579,303,140,5,1278
RAJASTHAN,BHARATPUR,BAYANA,1379,76,35,27,8,1525
RAJASTHAN,BHARATPUR,BEIR,394,2204,555,736,118,4007
RAJASTHAN,BHARATPUR,BHARATPUR,14,255,189,127,24,609
RAJASTHAN,BHARATPUR,DEEG,7,7,7,6,0,27
RAJASTHAN,BHARATPUR,KAMAN,11,32,2,3,1,49
RAJASTHAN,BHARATPUR,KUMBHER,0,1,1,0,1,3
RAJASTHAN,BHARATPUR,NADBAI,435,1082,264,112,12,1905
RAJASTHAN,BHARATPUR,NAGAR,1,2,3,2,2,10
RAJASTHAN,BHARATPUR,PAHARI,5,23,55,66,1,150
RAJASTHAN,BHARATPUR,ROOPBAS,25,206,132,29,2,394
RAJASTHAN,BHILWARA,ASIND,0,1,0,1,0,2
RAJASTHAN,BHILWARA,BANEDA,0,7,11,7,3,28
RAJASTHAN,BHILWARA,BHILWARA,10,17,8,12,8,55
RAJASTHAN,BHILWARA,BIJOLIYA,9,30,42,6,48,135
RAJASTHAN,BHILWARA,HURDA,1,2,8,4,0,15
RAJASTHAN,BHILWARA,JAHAJPUR,25,51,12,8,3,99
RAJASTHAN,BHILWARA,KOTADI,11,63,42,49,1,166
RAJASTHAN,BHILWARA,MANDAL,0,5,1,2,0,8
RAJASTHAN,BHILWARA,MANDALGARH,329,270,164,72,5,840
RAJASTHAN,BHILWARA,RAIPUR,0,3,1,1,3,8
RAJASTHAN,BHILWARA,SAHADA,2,7,12,2,1,24
RAJASTHAN,BIKANER,BIKANER,0,6,47,1023,866,1942
RAJASTHAN,BIKANER,DOONGAR GARH,1,188,60,333,2370,2952
RAJASTHAN,BIKANER,KOLAYAT,0,1,0,62,401,464
RAJASTHAN,BIKANER,LUNKARANSAR,2,210,19,3,1,235
RAJASTHAN,BIKANER,NOKHA,4,47,117,688,1907,2763
RAJASTHAN,BUNDI,BUNDI,501,367,357,36,36,1297
RAJASTHAN,BUNDI,HINDOLI,107,543,113,132,19,914
RAJASTHAN,BUNDI,INDRAGARH,24,3,2,4,0,33
RAJASTHAN,BUNDI,KESHORAIPATAN,129,57,6,20,1,213
RAJASTHAN,BUNDI,NAINWA,154,480,812,1064,172,2682
RAJASTHAN,CHITTORGARH,ARNOD,241,607,36,32,26,942
RAJASTHAN,CHITTORGARH,BADI SADRI,404,340,99,176,42,1061
RAJASTHAN,CHITTORGARH,BENGU,37,222,382,358,959,1958
RAJASTHAN,CHITTORGARH,BHADESAR,109,317,293,63,41,823
RAJASTHAN,CHITTORGARH,CHHOTI SADRI,1,88,648,577,624,1938
RAJASTHAN,CHITTORGARH,CHITTORGARH,169,195,822,896,692,2774
RAJASTHAN,CHITTORGARH,DUNGLA,139,252,52,20,2,465
RAJASTHAN,CHITTORGARH,GANGARAR,113,176,259,142,14,704
RAJASTHAN,CHITTORGARH,KAPASAN,251,21,38,79,66,455
RAJASTHAN,CHITTORGARH,NIMBAHERA,610,1438,352,368,254,3022
RAJASTHAN,CHITTORGARH,PRATAPGARH,0,4,11,12,27,54
RAJASTHAN,CHITTORGARH,RASHMI,255,175,16,13,2,461
RAJASTHAN,CHITTORGARH,RAWATBHATA,17,20,7,3,1,48
RAJASTHAN,CHURU,CHURU,0,0,1,0,0,1
RAJASTHAN,CHURU,RATANGARH,0,1,25,69,359,454
RAJASTHAN,CHURU,SARDAR SHAHAR,22,53,45,27,67,214
RAJASTHAN,CHURU,SUJANGARH,33,359,1140,505,680,2717
RAJASTHAN,DAUSA,BASWA,99,267,4,0,1,371
RAJASTHAN,DAUSA,DAUSA,27,11,79,69,2,188
RAJASTHAN,DAUSA,LALSOT,158,75,138,165,2,538
RAJASTHAN,DAUSA,MAHUA,978,518,304,151,90,2041
RAJASTHAN,DAUSA,SIKRAY,153,88,13,7,5,266
RAJASTHAN,DHOLPUR,BARI,51,55,44,9,4,163
RAJASTHAN,DHOLPUR,BASERI,0,12,20,25,0,57
RAJASTHAN,DHOLPUR,DHOLPUR,95,68,42,29,2,236
RAJASTHAN,DHOLPUR,RAJAKHERA,90,432,96,22,13,653
RAJASTHAN,DHOLPUR,SAPAIU,1,16,19,4,1,41
RAJASTHAN,DUNGARPUR,ASPUR,0,0,0,0,2,2
RAJASTHAN,DUNGARPUR,DUNGARPUR,0,1,0,0,0,1
RAJASTHAN,DUNGARPUR,SAGWARA,17,49,11,0,0,77
RAJASTHAN,DUNGARPUR,SIMALWARA,48,109,3,1,0,161
RAJASTHAN,HANUMANGARH,NOHAR,3,4,9,9,0,25
RAJASTHAN,JAIPUR,AMER,1142,170,181,796,724,3013
RAJASTHAN,JAIPUR,BASSI,322,264,149,55,6,796
RAJASTHAN,JAIPUR,CHAKSU,2,2,0,0,0,4
RAJASTHAN,JAIPUR,CHOMU,244,535,37,10,27,853
RAJASTHAN,JAIPUR,JAIPUR,29,281,20,10,1,341
RAJASTHAN,JAIPUR,JAMWARAMGARH,141,331,45,27,11,555
RAJASTHAN,JAIPUR,KOTPUTLI,0,2,4,0,0,6
RAJASTHAN,JAIPUR,MOUJMABAD,26,37,789,437,1,1290
RAJASTHAN,JAIPUR,PHAGI,14,1,0,0,0,15
RAJASTHAN,JAIPUR,PHULERA,11,338,98,15,0,462
RAJASTHAN,JAIPUR,SANGANER,450,197,631,254,133,1665
RAJASTHAN,JAIPUR,SHAHPURA,1783,432,133,403,248,2999
RAJASTHAN,JAIPUR,VIRATNAGAR,531,209,16,41,135,932
RAJASTHAN,JAISALMER,FATHEGARH,0,0,0,22,72,94
RAJASTHAN,JAISALMER,JAISALMER,102,582,107,216,34,1041
RAJASTHAN,JAISALMER,POKARAN,5,185,388,534,36,1148
RAJASTHAN,JALORE,AHORE,45,22,8,6,8,89
RAJASTHAN,JALORE,BAGODA,1,46,64,465,2320,2896
RAJASTHAN,JALORE,BHINMAL,21,113,277,304,970,1685
RAJASTHAN,JALORE,JALORE,94,352,386,234,12,1078
RAJASTHAN,JALORE,RANIWARA,46,55,158,104,5,368
RAJASTHAN,JALORE,SANCHORE,21,37,18,79,151,306
RAJASTHAN,JALORE,SAYLA,55,185,175,227,37,679
RAJASTHAN,JHALAWAR,AKLERA,0,1,1,1,0,3
RAJASTHAN,JHALAWAR,JHALARA PATAN,24,8,15,51,25,123
RAJASTHAN,JHALAWAR,KHANPUR,378,1645,648,587,8,3266
RAJASTHAN,JHALAWAR,MANOHAR THANA,0,2,4,0,0,6
RAJASTHAN,JHALAWAR,PACHPAHAR,45,20,23,20,1,109
RAJASTHAN,JHALAWAR,PIRAWA,16,25,21,104,62,228
RAJASTHAN,JHUNJHUNU,BUHANA,0,21,50,42,1,114
RAJASTHAN,JHUNJHUNU,CIDAWA,4,22,37,6,3,72
RAJASTHAN,JHUNJHUNU,JHUNJHUNU,17,40,9,10,2,78
RAJASTHAN,JHUNJHUNU,KHETDI,28,57,27,53,15,180
RAJASTHAN,JHUNJHUNU,NAWALGARH,36,356,137,71,15,615
RAJASTHAN,JHUNJHUNU,UDAIPURWATI,4,28,20,84,27,163
RAJASTHAN,JODHPUR,BHOPAL GARH,43,345,877,1077,2799,5141
RAJASTHAN,JODHPUR,BILADA,264,550,448,625,28,1915
RAJASTHAN,JODHPUR,JODHPUR,79,155,447,412,250,1343
RAJASTHAN,JODHPUR,LUNI,7,1,10,20,32,70
RAJASTHAN,JODHPUR,ONSIA,0,22,46,155,7921,8144
RAJASTHAN,JODHPUR,PHALODI,3,120,300,1100,1404,2927
RAJASTHAN,JODHPUR,SHER GARH,468,126,630,1428,124,2776
RAJASTHAN,KAROLI,HINDON,402,475,308,84,15,1284
RAJASTHAN,KAROLI,KAROLI,62,129,101,75,8,375
RAJASTHAN,KAROLI,MANDRAYAL,3,11,10,7,7,38
RAJASTHAN,KAROLI,NADOTI,36,59,17,13,0,125
RAJASTHAN,KAROLI,SAPOTRA,86,50,102,50,13,301
RAJASTHAN,KAROLI,TODA BHIM,358,816,639,552,190,2555
RAJASTHAN,KOTA,DIGOD,1168,1070,187,54,7,2486
RAJASTHAN,KOTA,LADPURA,267,1087,425,141,0,1920
RAJASTHAN,KOTA,PIPALLDA,1541,351,30,32,2,1956
RAJASTHAN,KOTA,RAMGANJMANDI,1,3,0,0,1,5
RAJASTHAN,KOTA,SANGOD,3442,2259,408,139,58,6306
RAJASTHAN,NAGAUR,DEEDWANA,2,5,0,0,0,7
RAJASTHAN,NAGAUR,DEGANA,29,288,190,57,103,667
RAJASTHAN,NAGAUR,JAYAL,599,95,111,42,30,877
RAJASTHAN,NAGAUR,KHEEVSAR,0,9,47,214,2126,2396
RAJASTHAN,NAGAUR,LADNU,13,160,385,141,261,960
RAJASTHAN,NAGAUR,MAKRANA,4,3,3,0,0,10
RAJASTHAN,NAGAUR,MERTA,88,337,774,2128,1341,4668
RAJASTHAN,NAGAUR,NAGAUR,166,178,433,792,1836,3405
RAJASTHAN,NAGAUR,NAWA,63,228,185,80,2,558
RAJASTHAN,NAGAUR,PARBATSAR,14,89,14,6,7,130
RAJASTHAN,PALI,BALI,1,1,1,1,6,10
RAJASTHAN,PALI,DESURI,9,13,24,2,0,48
RAJASTHAN,PALI,JAITARAN,12,118,244,350,41,765
RAJASTHAN,PALI,MARWAR JUNCTION,260,73,29,38,5,405
RAJASTHAN,PALI,PALI,10,11,1,0,2,24
RAJASTHAN,PALI,RAIPUR,1,2,3,0,0,6
RAJASTHAN,PALI,ROHAT,0,1,0,0,0,1
RAJASTHAN,PALI,SOJAT,81,135,18,14,0,248
RAJASTHAN,PALI,SUMERPUR,15,3,0,0,5,23
RAJASTHAN,RAJSAMAND,AMET,9,17,22,40,28,116
RAJASTHAN,RAJSAMAND,DEVGARH,0,0,0,0,1,1
RAJASTHAN,RAJSAMAND,NATHDWARA,1,6,15,16,22,60
RAJASTHAN,RAJSAMAND,RAILMAGRA,0,15,12,14,1,42
RAJASTHAN,RAJSAMAND,RAJSAMAND,18,39,50,27,35,169
RAJASTHAN,SAWAI MADHOPUR,BAMANWAS,12,6,0,0,3,21
RAJASTHAN,SAWAI MADHOPUR,BAOLI,0,1,0,0,1,2
RAJASTHAN,SAWAI MADHOPUR,CHOUTH KA BARWADA,8,63,85,133,15,304
RAJASTHAN,SAWAI MADHOPUR,GANGAPUR,203,22,1,0,1,227
RAJASTHAN,SAWAI MADHOPUR,KHANDAR,387,1090,285,97,21,1880
RAJASTHAN,SAWAI MADHOPUR,MALARNA DOONGAR,40,21,29,15,9,114
RAJASTHAN,SAWAI MADHOPUR,SAWAI MADHOPUR,690,260,208,198,15,1371
RAJASTHAN,SIKAR,DATARAM GARH,693,728,325,308,62,2116
RAJASTHAN,SIKAR,FATEHPUR,2,20,1,0,0,23
RAJASTHAN,SIKAR,LAXMAN GARH,27,447,121,53,2,650
RAJASTHAN,SIKAR,NEEM KA THANA,34,159,122,344,248,907
RAJASTHAN,SIKAR,SHRI MADHOPUR,622,616,642,576,653,3109
RAJASTHAN,SIKAR,SIKAR,48,341,864,641,154,2048
RAJASTHAN,SIROHI,ABUROAD,2,4,9,8,1,24
RAJASTHAN,SIROHI,PINDWARA,0,1,0,0,0,1
RAJASTHAN,SIROHI,REVDAR,1,3,4,0,1,9
RAJASTHAN,SIROHI,SHIVGANJ,3,34,31,22,4,94
RAJASTHAN,SIROHI,SIROHI,8,7,9,7,1,32
RAJASTHAN,TONK,DEOLI,3,1,3,0,0,7
RAJASTHAN,TONK,MALPURA,0,1,2,0,0,3
RAJASTHAN,TONK,NIWAI,0,1,3,0,0,4
RAJASTHAN,TONK,PEEPLU,0,0,0,1,0,1
RAJASTHAN,TONK,TONK,9,3,4,0,0,16
RAJASTHAN,TONK,UNIYARA,60,126,116,33,144,479
RAJASTHAN,UDAIPUR,DHARIYAVAD,0,30,17,6,1,54
RAJASTHAN,UDAIPUR,GIRWA,77,94,236,43,72,522
RAJASTHAN,UDAIPUR,GOGUNDA,0,1,1,0,1,3
RAJASTHAN,UDAIPUR,JHADOL,14,8,19,6,12,59
RAJASTHAN,UDAIPUR,KHERWADA,11,11,0,0,1,23
RAJASTHAN,UDAIPUR,MAWLI,8,50,36,36,30,160
RAJASTHAN,UDAIPUR,SARADA,0,1,1,0,2,4
RAJASTHAN,UDAIPUR,VALLABH NAGAR,103,107,212,48,3,473
TAMIL NADU,COIMBATORE,ANAMALAI,321,37,115,47,279,799
TAMIL NADU,COIMBATORE,ANNUR,358,38,21,82,731,1230
TAMIL NADU,COIMBATORE,AVINASHI,899,121,87,252,819,2178
TAMIL NADU,COIMBATORE,KINATHUKADAVU,998,91,21,31,13,1154
TAMIL NADU,COIMBATORE,KUDIMANGALAM,315,24,9,17,17,382
TAMIL NADU,COIMBATORE,MADATTHUKULAM,113,2,1,0,31,147
TAMIL NADU,COIMBATORE,MADUKKARAI,601,0,33,86,281,1001
TAMIL NADU,COIMBATORE,METTUPALAYAM,46,119,65,136,399,765
TAMIL NADU,COIMBATORE,PALLADAM,205,16,52,112,289,674
TAMIL NADU,COIMBATORE,PERIANAICKEN PALAYAM,390,14,120,153,157,834
TAMIL NADU,COIMBATORE,POLLACHI NORTH,484,70,140,0,5,699
TAMIL NADU,COIMBATORE,POLLACHI SOUTH,826,2,2,81,39,950
TAMIL NADU,COIMBATORE,PONGALUR,615,85,10,93,1,804
TAMIL NADU,COIMBATORE,SARCARSAMAKULAM,461,3,91,84,136,775
TAMIL NADU,COIMBATORE,SOOLUR,156,72,89,153,547,1017
TAMIL NADU,COIMBATORE,SULTHANPET,26,123,124,161,1295,1729
TAMIL NADU,COIMBATORE,THIRUPPUR,577,16,21,211,99,924
TAMIL NADU,COIMBATORE,THONDAMUTHUR,1563,126,241,22,63,2015
TAMIL NADU,COIMBATORE,UDUMALAIPETTAI,379,30,69,88,14,580
TAMIL NADU,CUDDALORE,ANNAGRAMAM,1612,28,702,35,105,2482
TAMIL NADU,CUDDALORE,BHUVANAGIRI,1218,204,3,5,1,1431
TAMIL NADU,CUDDALORE,CUDDALORE,2015,685,818,336,264,4118
TAMIL NADU,CUDDALORE,KAMMAPURAM,2279,155,47,13,65,2559
TAMIL NADU,CUDDALORE,KATTUMANNARKOIL,2110,226,192,5,7,2540
TAMIL NADU,CUDDALORE,KEERAPPALAYAM,1121,22,34,5,71,1253
TAMIL NADU,CUDDALORE,KUMARATCHI,229,2,5,4,0,240
TAMIL NADU,CUDDALORE,KURINJIPADY,1360,226,368,269,41,2264
TAMIL NADU,CUDDALORE,MANGALORE,532,23,0,34,74,663
TAMIL NADU,CUDDALORE,NALLUR,1109,63,10,213,20,1415
TAMIL NADU,CUDDALORE,PANRUTI,575,210,961,41,62,1849
TAMIL NADU,CUDDALORE,PARANGIPETTAI,229,1,3,0,0,233
TAMIL NADU,CUDDALORE,VRIDHACHALAM,1415,622,524,4,136,2701
TAMIL NADU,DHARMAPURI,DHARMAPURI,31,0,0,0,0,31
TAMIL NADU,DHARMAPURI,HARUR,18,0,0,1,1,20
TAMIL NADU,DHARMAPURI,KARIMANGALAM,1,0,0,0,0,1
TAMIL NADU,DHARMAPURI,MORAPPUR,41,1,0,0,0,42
TAMIL NADU,DHARMAPURI,NALLAMPALLI,29,0,1,1,0,31
TAMIL NADU,DHARMAPURI,PALACODE,1,0,0,0,0,1
TAMIL NADU,DHARMAPURI,PAPPIREDDIPATTY,6,1,0,0,0,7
TAMIL NADU,DHARMAPURI,PENNAGARAM,45,0,0,1,9,55
TAMIL NADU,DINDIGUL,ATHOOR,259,0,0,0,0,259
TAMIL NADU,DINDIGUL,BATLAGUNDU,7,0,0,0,0,7
TAMIL NADU,DINDIGUL,DINDIGUL,6,0,17,4,58,85
TAMIL NADU,DINDIGUL,GUZILIAMPARAI,372,12,40,16,190,630
TAMIL NADU,DINDIGUL,NATHAM,123,0,0,0,0,123
TAMIL NADU,DINDIGUL,NILAKOTTAI,6,0,0,0,0,6
TAMIL NADU,DINDIGUL,ODDANCHATRAM,2,0,21,0,0,23
TAMIL NADU,DINDIGUL,PALANI,84,5,5,0,1,95
TAMIL NADU,DINDIGUL,REDDIYARCHATRAM,30,0,0,0,0,30
TAMIL NADU,DINDIGUL,SHANARPATTI,113,33,3,2,121,272
TAMIL NADU,DINDIGUL,THOPPAMPATTI,15,0,0,1,46,62
TAMIL NADU,DINDIGUL,VADAMADURAI,258,11,4,63,0,336
TAMIL NADU,DINDIGUL,VEDASANDUR,301,14,129,56,5,505
TAMIL NADU,ERODE,AMMAPETTAI,3,453,9,27,50,542
TAMIL NADU,ERODE,ANTHIYUR,41,16,28,31,80,196
TAMIL NADU,ERODE,BHAVANI,133,160,60,162,63,578
TAMIL NADU,ERODE,BHAVANISAGAR,27,80,49,21,159,336
TAMIL NADU,ERODE,CHENNIMALAI,9,78,87,21,54,249
TAMIL NADU,ERODE,DHARAPURAM,19,62,8,8,17,114
TAMIL NADU,ERODE,ERODE,11,87,5,14,105,222
TAMIL NADU,ERODE,GOBICHETTIPALAYAM,154,491,157,194,666,1662
TAMIL NADU,ERODE,KANGEYAM,11,69,1,2,3,86
TAMIL NADU,ERODE,KODUMUDI,17,27,4,1,2,51
TAMIL NADU,ERODE,KUNDADAM,12,218,1,1,17,249
TAMIL NADU,ERODE,MODAKURICHI,19,161,0,1,6,187
TAMIL NADU,ERODE,MOOLANUR,6,59,2,10,50,127
TAMIL NADU,ERODE,NAMBIYUR,133,576,119,244,625,1697
TAMIL NADU,ERODE,PERUNTHURAI,150,573,12,25,61,821
TAMIL NADU,ERODE,SATHYAMANGALAM,73,58,45,104,301,581
TAMIL NADU,ERODE,THALAVADI,180,352,286,219,419,1456
TAMIL NADU,ERODE,THUKKANAICKENPALAYAM,59,95,60,35,66,315
TAMIL NADU,ERODE,UTHUKULI,138,197,141,178,95,749
TAMIL NADU,ERODE,VELLAKOIL,0,48,3,1,3,55
TAMIL NADU,KANCHEEPURAM,ACHIRAPPAKKAM,0,17,119,143,13,292
TAMIL NADU,KANCHEEPURAM,CHITHAMUR,0,55,96,0,0,151
TAMIL NADU,KANCHEEPURAM,KANCHEEPURAM,0,138,257,138,81,614
TAMIL NADU,KANCHEEPURAM,KATTANKULATHUR,0,0,83,0,0,83
TAMIL NADU,KANCHEEPURAM,KUNDRATHUR,1,8,21,7,0,37
TAMIL NADU,KANCHEEPURAM,LATHORE,0,0,176,20,19,215
TAMIL NADU,KANCHEEPURAM,MADHURANTHAGAM,0,0,229,0,82,311
TAMIL NADU,KANCHEEPURAM,SRIPERUMBUDUR,0,3,251,22,27,303
TAMIL NADU,KANCHEEPURAM,THIRUKAZHUKUNDRAM,72,0,476,25,55,628
TAMIL NADU,KANCHEEPURAM,TIRUPORUR,0,0,3,0,0,3
TAMIL NADU,KANCHEEPURAM,UTHIRAMERUR,0,0,11,1,1,13
TAMIL NADU,KANCHEEPURAM,WALAJABAD,0,16,69,162,62,309
TAMIL NADU,KANYAKUMARI,AGASTEESWARAM,143,1,0,0,0,144
TAMIL NADU,KANYAKUMARI,KILLIYOOR,10,3,1,1,3,18
TAMIL NADU,KANYAKUMARI,KURUNTHENCODE,32,0,0,0,0,32
TAMIL NADU,KANYAKUMARI,MELPURAM,3,0,0,0,0,3
TAMIL NADU,KANYAKUMARI,RAJAKKAMANGALAM,125,0,0,0,0,125
TAMIL NADU,KANYAKUMARI,THOVALAI,6,1,0,0,0,7
TAMIL NADU,KANYAKUMARI,THUCKALAY,13,0,0,0,0,13
TAMIL NADU,KARUR,ARAVAKURICHI,100,12,71,14,4,201
TAMIL NADU,KARUR,K.PARAMATHI,31,1,1,11,74,118
TAMIL NADU,KARUR,KADAVUR,387,263,14,7,12,683
TAMIL NADU,KARUR,KARUR,85,72,12,17,3,189
TAMIL NADU,KARUR,KRISHNARAYAPURAM,150,6,1,9,5,171
TAMIL NADU,KARUR,KULITHALAI,85,31,4,3,0,123
TAMIL NADU,KARUR,THANTHONI,164,45,33,305,64,611
TAMIL NADU,KARUR,THOGAMALAI,350,9,9,7,2,377
TAMIL NADU,KRISHNAGIRI,BARUGUR,93,35,5,25,3,161
TAMIL NADU,KRISHNAGIRI,HOSUR,327,5,46,222,665,1265
TAMIL NADU,KRISHNAGIRI,KAVERIPATTINAM,93,1,0,1,0,95
TAMIL NADU,KRISHNAGIRI,KELAMANGALAM(DEN),164,30,57,234,147,632
TAMIL NADU,KRISHNAGIRI,KRISHNAGIRI,72,12,7,14,22,127
TAMIL NADU,KRISHNAGIRI,MATHUR,4,0,0,0,0,4
TAMIL NADU,KRISHNAGIRI,SHOOLAGIRI,82,31,107,59,607,886
TAMIL NADU,KRISHNAGIRI,THALLY,274,148,245,433,445,1545
TAMIL NADU,KRISHNAGIRI,UTHANGARAI,13,1,0,1,0,15
TAMIL NADU,KRISHNAGIRI,VEPPANAPALLI,42,36,1,10,16,105
TAMIL NADU,MADURAI,ALANGANALLUR,122,26,2,93,0,243
TAMIL NADU,MADURAI,CHELLAMPATTI,8,0,0,0,0,8
TAMIL NADU,MADURAI,KALLIKUDI,0,4,0,0,0,4
TAMIL NADU,MADURAI,KALLUPATTI(T),1,0,0,0,0,1
TAMIL NADU,MADURAI,KOTTAMPATTI,37,0,0,0,0,37
TAMIL NADU,MADURAI,MELUR,6,0,0,0,0,6
TAMIL NADU,MADURAI,SEDAPATTI,7,2,0,0,0,9
TAMIL NADU,MADURAI,THIRUPPARANKUNDRAM,28,0,0,0,0,28
TAMIL NADU,MADURAI,TIRUMANGALAM,0,3,0,0,0,3
TAMIL NADU,MADURAI,USILAMPATTI,4,0,0,0,0,4
TAMIL NADU,MADURAI,VADIPATTI,163,0,0,0,0,163
TAMIL NADU,NAGAPATTINAM,KEELVELUR,110,0,0,0,1,111
TAMIL NADU,NAGAPATTINAM,KOLLIDAM,198,0,1,0,0,199
TAMIL NADU,NAGAPATTINAM,KUTTALAM,467,0,0,3,1,471
TAMIL NADU,NAGAPATTINAM,MAYILADUTHURAI,52,2,0,0,0,54
TAMIL NADU,NAGAPATTINAM,NAGAPATTINAM,2,0,0,0,0,2
TAMIL NADU,NAGAPATTINAM,SEMBANARKOIL,1828,2,0,1,59,1890
TAMIL NADU,NAGAPATTINAM,SIRKALI,225,0,1,0,0,226
TAMIL NADU,NAGAPATTINAM,THIRUMARUGAL,3,0,0,0,0,3
TAMIL NADU,NAGAPATTINAM,VEDARNIYAM,4,0,0,0,0,4
TAMIL NADU,NAMAKKAL,ELACHIPALAYAM,214,8,4,37,524,787
TAMIL NADU,NAMAKKAL,ERUMAIPATTY,25,1,13,9,180,228
TAMIL NADU,NAMAKKAL,KABILARMALAI,8,0,12,0,6,26
TAMIL NADU,NAMAKKAL,MALLASAMUDRAM,23,1,35,52,218,329
TAMIL NADU,NAMAKKAL,MOHANUR,55,1,58,33,8,155
TAMIL NADU,NAMAKKAL,NAMAGIRIPET,129,52,42,61,39,323
TAMIL NADU,NAMAKKAL,NAMAKKAL,24,3,157,148,34,366
TAMIL NADU,NAMAKKAL,PALLIPALAYAM,29,0,154,6,35,224
TAMIL NADU,NAMAKKAL,PARAMATHI,30,4,13,22,274,343
TAMIL NADU,NAMAKKAL,PUDUCHATTIRAM,104,5,149,164,1,423
TAMIL NADU,NAMAKKAL,RASIPURAM,3,1,1,7,12,24
TAMIL NADU,NAMAKKAL,SENDAMANGALAM,5,0,23,39,62,129
TAMIL NADU,NAMAKKAL,TIRUCHENGODE,84,1,366,29,347,827
TAMIL NADU,NAMAKKAL,VENNANDHUR,43,6,15,18,40,122
TAMIL NADU,NILGIRIS,COONOOR,1,0,0,0,0,1
TAMIL NADU,PERAMBALUR,ALATHUR,105,0,0,0,1,106
TAMIL NADU,PERAMBALUR,ANDIMADAM,432,17,43,53,15,560
TAMIL NADU,PERAMBALUR,ARIYALUR,322,60,36,65,12,495
TAMIL NADU,PERAMBALUR,JAYANKONDAM,186,92,125,137,76,616
TAMIL NADU,PERAMBALUR,PERAMBALUR,27,0,0,1,0,28
TAMIL NADU,PERAMBALUR,SENDURAI,209,20,50,5,9,293
TAMIL NADU,PERAMBALUR,THIRUMANUR,114,2,85,58,8,267
TAMIL NADU,PERAMBALUR,TPALUR,361,101,106,133,125,826
TAMIL NADU,PERAMBALUR,VEPPANTHATTAI,3,0,0,0,0,3
TAMIL NADU,PERAMBALUR,VEPPUR,499,69,74,27,28,697
TAMIL NADU,PUDUKKOTTAI,ANNAVASAL,3,0,0,13,0,16
TAMIL NADU,PUDUKKOTTAI,ARANTHANGI,165,781,311,139,97,1493
TAMIL NADU,PUDUKKOTTAI,ARIMALAM,1,0,0,0,0,1
TAMIL NADU,PUDUKKOTTAI,AVUDAYARKOIL,2,4,0,0,0,6
TAMIL NADU,PUDUKKOTTAI,GANDARVAKKOTTAI,1067,65,67,26,7,1232
TAMIL NADU,PUDUKKOTTAI,KARAMBAKUDI,254,693,685,770,51,2453
TAMIL NADU,PUDUKKOTTAI,KUNNANDARKOIL,1,0,0,0,0,1
TAMIL NADU,PUDUKKOTTAI,MANAMELKUDI,15,0,0,0,0,15
TAMIL NADU,PUDUKKOTTAI,PONNAMARAVATHI,1,0,0,0,0,1
TAMIL NADU,PUDUKKOTTAI,PUDUKKOTTAI,168,103,123,2,29,425
TAMIL NADU,PUDUKKOTTAI,THIRUMAYAM,3,0,0,0,0,3
TAMIL NADU,PUDUKKOTTAI,THIRUVARANKULAM,744,707,739,782,482,3454
TAMIL NADU,PUDUKKOTTAI,VIRALIMALAI,35,3,1,2,1,42
TAMIL NADU,RAMANATHAPURAM,BOGALUR,11,7,0,0,0,18
TAMIL NADU,RAMANATHAPURAM,KADALADI,67,0,0,0,0,67
TAMIL NADU,RAMANATHAPURAM,KAMUDI,285,0,3,0,0,288
TAMIL NADU,RAMANATHAPURAM,MUDUKULATHUR,709,0,1,1,2,713
TAMIL NADU,RAMANATHAPURAM,NAINARKOIL,114,0,0,0,0,114
TAMIL NADU,RAMANATHAPURAM,PARAMAKKUDI,188,44,0,0,11,243
TAMIL NADU,RAMANATHAPURAM,RAMANATHAPURAM,1,0,0,0,0,1
TAMIL NADU,SALEM,ATTUR,299,44,73,115,21,552
TAMIL NADU,SALEM,AYODYAPATTANAM,221,15,11,35,67,349
TAMIL NADU,SALEM,EDAPPADI,594,58,339,143,71,1205
TAMIL NADU,SALEM,GANGAVALLI,396,26,16,28,46,512
TAMIL NADU,SALEM,KADAYAMPATTI,791,0,0,20,90,901
TAMIL NADU,SALEM,KOLATHUR,25,9,0,4,10,48
TAMIL NADU,SALEM,KONGANAPURAM,262,24,150,233,182,851
TAMIL NADU,SALEM,MAGUDANCHAVADI,94,4,18,28,14,158
TAMIL NADU,SALEM,MECHERI,207,3,204,92,86,592
TAMIL NADU,SALEM,NANGAVALLI,249,76,87,109,10,531
TAMIL NADU,SALEM,OMALUR,625,40,4,135,456,1260
TAMIL NADU,SALEM,PANAMARATHUPATTI,62,6,5,9,4,86
TAMIL NADU,SALEM,PEDDANAICKENPALAYAM,77,111,156,482,512,1338
TAMIL NADU,SALEM,SALEM,41,2,4,6,27,80
TAMIL NADU,SALEM,SANKARI,337,13,29,126,309,814
TAMIL NADU,SALEM,THALAIVASAL,111,5,82,101,170,469
TAMIL NADU,SALEM,THARAMANGALAM,710,0,1,111,205,1027
TAMIL NADU,SALEM,VALAPPADY,1,4,0,8,138,151
TAMIL NADU,SALEM,VEERAPANDI,190,2,27,1,44,264
TAMIL NADU,SIVAGANGA,DEVAKOTTAI,190,5,0,0,7,202
TAMIL NADU,SIVAGANGA,ILAYANGUDI,550,42,0,4,11,607
TAMIL NADU,SIVAGANGA,KALAYARKOVIL,113,0,2,2,8,125
TAMIL NADU,SIVAGANGA,KALLAL,9,3,0,0,7,19
TAMIL NADU,SIVAGANGA,KANNANGUDI,38,3,0,0,10,51
TAMIL NADU,SIVAGANGA,MANAMADURAI,51,0,0,0,0,51
TAMIL NADU,SIVAGANGA,S. PUDUR,13,0,0,0,0,13
TAMIL NADU,SIVAGANGA,SAKKOTTAI,110,13,2,1,0,126
TAMIL NADU,SIVAGANGA,SINGAMPUNERI,8,0,0,0,0,8
TAMIL NADU,SIVAGANGA,SIVAGANGA,22,0,0,0,2,24
TAMIL NADU,SIVAGANGA,THIRUPPATTUR,52,1,0,0,0,53
TAMIL NADU,SIVAGANGA,THIRUPPAVANAM,73,9,0,0,23,105
TAMIL NADU,THANJAVUR,AMMAPETTAI,1310,640,317,179,41,2487
TAMIL NADU,THANJAVUR,BUDHALUR,97,42,0,0,2,141
TAMIL NADU,THANJAVUR,KUMBAKONAM,767,59,2,5,138,971
TAMIL NADU,THANJAVUR,MADHUKUR,500,2325,172,404,169,3570
TAMIL NADU,THANJAVUR,ORATHANADU,230,1412,1464,1003,1018,5127
TAMIL NADU,THANJAVUR,PAPANASAM,561,36,4,0,0,601
TAMIL NADU,THANJAVUR,PATTUKOTTAI,789,1492,203,1168,395,4047
TAMIL NADU,THANJAVUR,PERAVURANI,481,1220,448,231,282,2662
TAMIL NADU,THANJAVUR,SEDHUBAVACHATTIRAM,407,961,262,355,79,2064
TAMIL NADU,THANJAVUR,THANJAVUR,1301,141,184,323,158,2107
TAMIL NADU,THANJAVUR,THIRUPANANDAL,869,32,0,4,1,906
TAMIL NADU,THANJAVUR,THIRUVAIYARU,26,0,0,0,0,26
TAMIL NADU,THANJAVUR,THIRUVIDAIMARUDUR,631,0,0,0,0,631
TAMIL NADU,THANJAVUR,THIRUVONAM,79,755,513,376,116,1839
TAMIL NADU,THENI,ANDIPATTI,24,0,0,0,0,24
TAMIL NADU,THENI,BODI,49,0,0,0,0,49
TAMIL NADU,THENI,CHINNAMANNUR,132,0,0,0,0,132
TAMIL NADU,THENI,CUMBUM,207,0,0,0,0,207
TAMIL NADU,THENI,MYILADUMPARAI,7,0,0,0,0,7
TAMIL NADU,THENI,PERIYAKULAM,139,1,0,0,1,141
TAMIL NADU,THENI,THENI,2,3,1,0,7,13
TAMIL NADU,THENI,UTHAMAPALAYAM,206,0,0,0,0,206
TAMIL NADU,THIRUVALLUR,ELLAPURAM,191,0,0,0,0,191
TAMIL NADU,THIRUVALLUR,GUMMIDIPOONDI,244,0,0,0,2,246
TAMIL NADU,THIRUVALLUR,KADAMBATHUR,31,0,0,0,0,31
TAMIL NADU,THIRUVALLUR,MINJUR,366,31,0,0,2,399
TAMIL NADU,THIRUVALLUR,PALLIPATTU,153,0,0,0,0,153
TAMIL NADU,THIRUVALLUR,POONAMALLEE,235,128,0,0,0,363
TAMIL NADU,THIRUVALLUR,POONDI,215,1,0,0,0,216
TAMIL NADU,THIRUVALLUR,PUZAL,71,1,0,0,0,72
TAMIL NADU,THIRUVALLUR,R.K.PEET,203,0,0,0,0,203
TAMIL NADU,THIRUVALLUR,SHOLAVARAM,21,5,0,0,0,26
TAMIL NADU,THIRUVALLUR,THIRUVALANGADU,556,0,0,1,0,557
TAMIL NADU,THIRUVALLUR,THIRUVALLUR,75,12,0,0,0,87
TAMIL NADU,THIRUVALLUR,TIRUTTANI,327,0,0,0,0,327
TAMIL NADU,THIRUVALLUR,VILLIVAKKAM,80,0,0,1,0,81
TAMIL NADU,THIRUVARUR,KORADACHERRY,558,10,1,0,0,569
TAMIL NADU,THIRUVARUR,KOTTUR,996,21,2,0,1,1020
TAMIL NADU,THIRUVARUR,KUDAVASAL,867,4,0,0,3,874
TAMIL NADU,THIRUVARUR,MANNARGUDI,1633,234,71,68,44,2050
TAMIL NADU,THIRUVARUR,MUTHUPETTAI,7,0,0,0,0,7
TAMIL NADU,THIRUVARUR,NANNILAM,1341,1,4,1,2,1349
TAMIL NADU,THIRUVARUR,NEEDAMANGALAM,1851,96,6,1,27,1981
TAMIL NADU,THIRUVARUR,THIRUVARUR,381,1,0,1,1,384
TAMIL NADU,THIRUVARUR,VALANGAIMAN,1498,6,0,0,2,1506
TAMIL NADU,TIRUCHIRAPPALLI,LALGUDI,1,10,0,0,0,11
TAMIL NADU,TIRUCHIRAPPALLI,MANAPPARAI,49,0,0,0,0,49
TAMIL NADU,TIRUCHIRAPPALLI,MANIKANDAM,35,0,0,0,0,35
TAMIL NADU,TIRUCHIRAPPALLI,MANNACHANALLUR,45,4,0,0,1,50
TAMIL NADU,TIRUCHIRAPPALLI,MARUNGAPURI,662,0,0,0,0,662
TAMIL NADU,TIRUCHIRAPPALLI,MUSIRI,89,7,16,38,15,165
TAMIL NADU,TIRUCHIRAPPALLI,PULLAMBADI,151,0,0,0,0,151
TAMIL NADU,TIRUCHIRAPPALLI,THATHAYANGARPETTAI,18,0,0,2,0,20
TAMIL NADU,TIRUCHIRAPPALLI,THIRUVERUMBUR,10,0,0,0,0,10
TAMIL NADU,TIRUCHIRAPPALLI,THOTTIYAM,1,0,0,0,0,1
TAMIL NADU,TIRUCHIRAPPALLI,THURAIYUR,152,0,0,1,0,153
TAMIL NADU,TIRUCHIRAPPALLI,UPPILIAPURAM,61,0,4,1,21,87
TAMIL NADU,TIRUCHIRAPPALLI,VAIYAMPATTY,45,6,12,2,2,67
TAMIL NADU,TIRUNELVELI,ALANGULAM,38,1,0,0,1,40
TAMIL NADU,TIRUNELVELI,CHERANMAHADEVI,6,3,0,0,0,9
TAMIL NADU,TIRUNELVELI,KADAYAM,17,0,1,0,0,18
TAMIL NADU,TIRUNELVELI,KADAYANALLUR,36,2,6,18,14,76
TAMIL NADU,TIRUNELVELI,KALAKAD,10,0,4,0,0,14
TAMIL NADU,TIRUNELVELI,KEELAPAVOOR,8,1,0,0,0,9
TAMIL NADU,TIRUNELVELI,KURUVIKULAM,1,0,0,0,0,1
TAMIL NADU,TIRUNELVELI,MANUR,36,0,1,1,0,38
TAMIL NADU,TIRUNELVELI,MELANEELITHANALLUR,8,0,0,0,0,8
TAMIL NADU,TIRUNELVELI,NANGUNERI,46,1,0,6,4,57
TAMIL NADU,TIRUNELVELI,PALAYAMKOTTAI,19,0,0,1,1,21
TAMIL NADU,TIRUNELVELI,RADHAPURAM,64,9,1,1,47,122
TAMIL NADU,TIRUNELVELI,SANKARANKOVIL,11,1,0,0,0,12
TAMIL NADU,TIRUNELVELI,SHENCOTTAI,34,9,6,14,0,63
TAMIL NADU,TIRUNELVELI,TENKASI,8,2,6,2,3,21
TAMIL NADU,TIRUNELVELI,VALLIOOR,38,1,7,7,0,53
TAMIL NADU,TIRUNELVELI,VASUDEVANALLUR,7,1,0,0,0,8
TAMIL NADU,TIRUVANNAMALAI,ANAKKAVUR,6,0,0,0,0,6
TAMIL NADU,TIRUVANNAMALAI,ARNI,3,0,0,0,0,3
TAMIL NADU,TIRUVANNAMALAI,CHENGAM,3,0,0,0,0,3
TAMIL NADU,TIRUVANNAMALAI,CHETPET,57,0,0,0,0,57
TAMIL NADU,TIRUVANNAMALAI,CHEYYAR,3,0,0,0,0,3
TAMIL NADU,TIRUVANNAMALAI,KALASAPAKKAM,10,0,0,0,0,10
TAMIL NADU,TIRUVANNAMALAI,KILPENNATHUR,7,0,0,0,0,7
TAMIL NADU,TIRUVANNAMALAI,PERNAMALLUR,3,0,0,0,0,3
TAMIL NADU,TIRUVANNAMALAI,POLUR,24,0,0,3,1,28
TAMIL NADU,TIRUVANNAMALAI,PUDUPALAYAM,1,0,0,0,0,1
TAMIL NADU,TIRUVANNAMALAI,THANDARAMPET,2,0,0,0,0,2
TAMIL NADU,TIRUVANNAMALAI,THELLAR,1,0,0,0,0,1
TAMIL NADU,TIRUVANNAMALAI,THURINJAPURAM,17,0,0,0,0,17
TAMIL NADU,TIRUVANNAMALAI,TIRUVANNAMALAI,29,0,0,0,0,29
TAMIL NADU,TIRUVANNAMALAI,VANDAVASI,1,0,0,0,0,1
TAMIL NADU,TIRUVANNAMALAI,VEMBAKKAM,56,9,4,79,60,208
TAMIL NADU,TIRUVANNAMALAI,WEST ARNI,34,0,0,0,0,34
TAMIL NADU,TUTICORIN DISTRICT,ALWARTHIRUNAGARI,11,0,0,0,1,12
TAMIL NADU,TUTICORIN DISTRICT,KARUNGULAM,14,0,0,0,1,15
TAMIL NADU,TUTICORIN DISTRICT,KAYATHAR,21,0,0,0,0,21
TAMIL NADU,TUTICORIN DISTRICT,KOVILPATTI,8,0,0,0,0,8
TAMIL NADU,TUTICORIN DISTRICT,OTTAPIDARAM,3,0,0,0,0,3
TAMIL NADU,TUTICORIN DISTRICT,SATTANKULAM,43,0,1,0,7,51
TAMIL NADU,TUTICORIN DISTRICT,SRIVAIKUNTAM,55,0,0,0,0,55
TAMIL NADU,TUTICORIN DISTRICT,THOOTHUKKUDI,5,0,0,0,0,5
TAMIL NADU,TUTICORIN DISTRICT,TIRUCHENDUR,2,0,0,0,0,2
TAMIL NADU,TUTICORIN DISTRICT,UDANGUDI,3,0,0,0,0,3
TAMIL NADU,TUTICORIN DISTRICT,VILATHIKULAM,112,0,0,0,56,168
TAMIL NADU,VELLORE,ALANGAYAM,11,0,0,0,2,13
TAMIL NADU,VELLORE,ANAICUT,132,7,4,5,45,193
TAMIL NADU,VELLORE,ARAKONAM,325,13,25,9,9,381
TAMIL NADU,VELLORE,ARCOT,135,11,4,0,3,153
TAMIL NADU,VELLORE,GUDIYATHAM,49,0,0,20,25,94
TAMIL NADU,VELLORE,JOLARPET,142,17,28,0,0,187
TAMIL NADU,VELLORE,K.V.KUPPAM,255,15,9,40,158,477
TAMIL NADU,VELLORE,KANDHILI,58,2,6,3,8,77
TAMIL NADU,VELLORE,KANIYAMBADI,51,19,11,3,3,87
TAMIL NADU,VELLORE,KATPADI,230,26,16,19,57,348
TAMIL NADU,VELLORE,KAVERIPAKKAM,895,19,0,1,3,918
TAMIL NADU,VELLORE,MADHANUR,59,2,1,2,17,81
TAMIL NADU,VELLORE,NATRAMPALLI,388,3,1,1,3,396
TAMIL NADU,VELLORE,NEMILI,1309,73,38,1,1,1422
TAMIL NADU,VELLORE,PERNAMBUT,26,6,8,5,0,45
TAMIL NADU,VELLORE,SHOLINGUR,167,19,6,11,19,222
TAMIL NADU,VELLORE,THIMIRI,130,0,1,3,1,135
TAMIL NADU,VELLORE,THIRUPATTUR,58,2,20,13,2,95
TAMIL NADU,VELLORE,VELLORE,64,8,1,3,1,77
TAMIL NADU,VELLORE,WALAJAH,132,3,0,0,3,138
TAMIL NADU,VILLUPPURAM,CHINNA SALEM,3,1,0,0,0,4
TAMIL NADU,VILLUPPURAM,GINGEE,20,1,0,0,0,21
TAMIL NADU,VILLUPPURAM,KALLAKURICHI,24,0,1,4,0,29
TAMIL NADU,VILLUPPURAM,KANAI,135,0,0,0,1,136
TAMIL NADU,VILLUPPURAM,KANDAMANGALAM,3725,363,5,56,12,4161
TAMIL NADU,VILLUPPURAM,KOLIYANUR,1879,38,8,52,52,2029
TAMIL NADU,VILLUPPURAM,MARAKKANAM,239,0,0,0,0,239
TAMIL NADU,VILLUPPURAM,MAYILAM,97,3,0,0,0,100
TAMIL NADU,VILLUPPURAM,MELMALAIYANUR,2,0,0,0,0,2
TAMIL NADU,VILLUPPURAM,MUGAIYUR,8,0,0,0,0,8
TAMIL NADU,VILLUPPURAM,RISHIVANTHAYAM,45,4,1,0,0,50
TAMIL NADU,VILLUPPURAM,THIRUKKOYILUR,205,0,0,0,0,205
TAMIL NADU,VILLUPPURAM,THIRUNAVALUR,415,23,1,0,0,439
TAMIL NADU,VILLUPPURAM,THIRUVENNAINALLUR,1202,0,0,0,0,1202
TAMIL NADU,VILLUPPURAM,THIYAGADHURGAM,2,0,0,0,0,2
TAMIL NADU,VILLUPPURAM,ULUNDURPET,51,0,0,0,0,51
TAMIL NADU,VILLUPPURAM,VAANOOR,807,173,323,51,124,1478
TAMIL NADU,VILLUPPURAM,VALLAM,47,30,63,19,1,160
TAMIL NADU,VILLUPPURAM,VIKKIRAVANDI,215,0,0,37,5,257
TAMIL NADU,VIRUDHUNAGAR,ARUPPUKOTTAI,24,0,0,0,0,24
TAMIL NADU,VIRUDHUNAGAR,KARIAPATTI,68,0,0,0,0,68
TAMIL NADU,VIRUDHUNAGAR,NARIKUDI,1,1,0,1,0,3
TAMIL NADU,VIRUDHUNAGAR,RAJAPALAYAM,15,0,0,0,0,15
TAMIL NADU,VIRUDHUNAGAR,SATTUR,8,1,0,0,0,9
TAMIL NADU,VIRUDHUNAGAR,SIVAKASI,1,0,0,0,0,1
TAMIL NADU,VIRUDHUNAGAR,SRIVILLIPUTUR,15,1,1,0,1,18
TAMIL NADU,VIRUDHUNAGAR,TIRUCHULI,14,2,0,0,0,16
TAMIL NADU,VIRUDHUNAGAR,VEMBAKKOTTAI,0,1,0,0,0,1
TAMIL NADU,VIRUDHUNAGAR,VIRUDHUNAGAR,25,1,0,0,2,28
TAMIL NADU,VIRUDHUNAGAR,WATRAP,76,0,0,67,2,145
TRIPURA,DHALAI,AMBASSA,0,1,0,0,0,1
TRIPURA,NORTH TRIPURA,GOURNAGAR,0,2,0,0,0,2
TRIPURA,NORTH TRIPURA,KADAMTALA,0,4,0,0,0,4
TRIPURA,NORTH TRIPURA,KUMARGHAT,0,1,0,0,0,1
TRIPURA,NORTH TRIPURA,PANISAGAR,0,1,0,0,0,1
TRIPURA,SOUTH TRIPURA,BAGAFA,0,3,0,0,0,3
TRIPURA,SOUTH TRIPURA,HRISHYAMUKH,0,1,0,0,0,1
TRIPURA,SOUTH TRIPURA,KAKRABAN,0,7,0,0,0,7
TRIPURA,SOUTH TRIPURA,MATABARI,0,9,0,0,0,9
TRIPURA,SOUTH TRIPURA,RAJNAGAR,0,5,0,0,0,5
TRIPURA,SOUTH TRIPURA,RUPAICHARI,0,1,0,0,0,1
TRIPURA,SOUTH TRIPURA,SATCHAND,0,1,0,0,0,1
TRIPURA,WEST TRIPURA,BISHALGARH,0,24,0,0,0,24
TRIPURA,WEST TRIPURA,BOXANAGAR,0,9,0,0,0,9
TRIPURA,WEST TRIPURA,DUKLI,0,5,0,0,0,5
TRIPURA,WEST TRIPURA,HEZAMARA,0,4,0,0,0,4
TRIPURA,WEST TRIPURA,JIRANIA,0,8,0,0,0,8
TRIPURA,WEST TRIPURA,JUMPUIJALA,0,2,0,0,0,2
TRIPURA,WEST TRIPURA,KATHALIA,0,2,0,0,0,2
TRIPURA,WEST TRIPURA,KHOWAI,0,3,0,0,0,3
TRIPURA,WEST TRIPURA,MANDAI,0,2,0,0,0,2
TRIPURA,WEST TRIPURA,MELAGHAR,0,17,0,0,0,17
TRIPURA,WEST TRIPURA,MOHANPUR,0,47,0,0,0,47
TRIPURA,WEST TRIPURA,PADMABIL,0,2,0,0,0,2
TRIPURA,WEST TRIPURA,TELIAMURA,0,4,0,0,0,4
TRIPURA,WEST TRIPURA,TULASHIKHAR,0,1,0,0,0,1
UTTAR PRADESH,AGRA,ACHNERA,2,2,0,0,0,4
UTTAR PRADESH,AGRA,AKOLA,27,10,0,0,3,40
UTTAR PRADESH,AGRA,BAH,6,135,0,15,2,158
UTTAR PRADESH,AGRA,BAMROLI AHIR,27,19,5,0,4,55
UTTAR PRADESH,AGRA,BICHPURI,2,17,0,0,0,19
UTTAR PRADESH,AGRA,FATEHABAD,1,112,6,0,1,120
UTTAR PRADESH,AGRA,FATEHPUR SIKRI,3,13,0,0,0,16
UTTAR PRADESH,AGRA,JAGNER,0,1,0,0,2,3
UTTAR PRADESH,AGRA,JETPUR KALAN,1,86,0,3,0,90
UTTAR PRADESH,AGRA,KHANDOLI,76,84,1,0,3,164
UTTAR PRADESH,AGRA,KHERA GARH,20,2,0,1,2,25
UTTAR PRADESH,AGRA,PINAHAT,44,107,2,11,6,170
UTTAR PRADESH,AGRA,SAIYA,1,4,0,0,1,6
UTTAR PRADESH,AGRA,SHAMSABAD,3,36,0,0,0,39
UTTAR PRADESH,ALIGARH,AKRABAD,9,28,3,1,0,41
UTTAR PRADESH,ALIGARH,ATRAULI,32,81,24,16,19,172
UTTAR PRADESH,ALIGARH,CHANDOUS,19,63,4,2,1,89
UTTAR PRADESH,ALIGARH,DHANIPUR,12,25,0,0,1,38
UTTAR PRADESH,ALIGARH,GANGIRI,1,8,0,0,0,9
UTTAR PRADESH,ALIGARH,GONDA,4,8,0,0,2,14
UTTAR PRADESH,ALIGARH,IGLAS,7,52,1,0,1,61
UTTAR PRADESH,ALIGARH,JAWA,4,35,5,1,1,46
UTTAR PRADESH,ALIGARH,KHAIR,30,28,3,0,0,61
UTTAR PRADESH,ALIGARH,LODHA,20,29,0,3,0,52
UTTAR PRADESH,ALIGARH,TAPPAL,5,67,1,1,0,74
UTTAR PRADESH,ALIGARH,VIJOLI,0,25,0,0,0,25
UTTAR PRADESH,ALLAHABAD,BAHADURPUR,22,133,9,0,1,165
UTTAR PRADESH,ALLAHABAD,BAHRIA,82,23,4,3,22,134
UTTAR PRADESH,ALLAHABAD,CHAKA,51,7,7,6,4,75
UTTAR PRADESH,ALLAHABAD,DHANUPUR,0,0,1,1,0,2
UTTAR PRADESH,ALLAHABAD,HANDIA,15,7,7,0,2,31
UTTAR PRADESH,ALLAHABAD,HOLAGARH,0,1,0,0,0,1
UTTAR PRADESH,ALLAHABAD,JASRA,3,3,1,5,0,12
UTTAR PRADESH,ALLAHABAD,KARCHHANA,136,177,22,23,19,377
UTTAR PRADESH,ALLAHABAD,KAUDHIVARA,14,21,5,5,1,46
UTTAR PRADESH,ALLAHABAD,KAURIHAR,41,12,4,1,1,59
UTTAR PRADESH,ALLAHABAD,KORAON,7,68,2,13,5,95
UTTAR PRADESH,ALLAHABAD,MAIJA,26,3,6,1,0,36
UTTAR PRADESH,ALLAHABAD,MANDA,11,20,2,4,1,38
UTTAR PRADESH,ALLAHABAD,MAUAIMA,1,21,0,0,0,22
UTTAR PRADESH,ALLAHABAD,PHULPUR,9,32,10,0,3,54
UTTAR PRADESH,ALLAHABAD,PRATAPPUR,14,40,5,6,13,78
UTTAR PRADESH,ALLAHABAD,SAIDABADA,5,18,20,19,4,66
UTTAR PRADESH,ALLAHABAD,SHANKARGARH,0,6,1,1,4,12
UTTAR PRADESH,ALLAHABAD,SORAON,3,30,1,0,0,34
UTTAR PRADESH,ALLAHABAD,URUWAN,145,65,39,2,2,253
UTTAR PRADESH,AMBEDAKAR NAGAR,AKBARPUR,9,51,7,6,50,123
UTTAR PRADESH,AMBEDAKAR NAGAR,BHASKHARI,4,4,1,1,0,10
UTTAR PRADESH,AMBEDAKAR NAGAR,BHEETI,19,33,8,11,61,132
UTTAR PRADESH,AMBEDAKAR NAGAR,BHIYAON,0,5,1,0,26,32
UTTAR PRADESH,AMBEDAKAR NAGAR,JAHAGHERA GANJ,8,19,3,1,12,43
UTTAR PRADESH,AMBEDAKAR NAGAR,JALALPUR,9,18,6,6,24,63
UTTAR PRADESH,AMBEDAKAR NAGAR,KATEHARI,11,29,4,1,20,65
UTTAR PRADESH,AMBEDAKAR NAGAR,RAMNAGAR,1,2,0,1,2,6
UTTAR PRADESH,AMBEDAKAR NAGAR,TANDA,0,7,0,3,5,15
UTTAR PRADESH,AURAIYA,ACHALDA,3,43,0,0,33,79
UTTAR PRADESH,AURAIYA,AJEETMAL,3,12,0,1,44,60
UTTAR PRADESH,AURAIYA,ARVA KATARA,7,42,17,5,44,115
UTTAR PRADESH,AURAIYA,AURIAYA,9,7,4,2,16,38
UTTAR PRADESH,AURAIYA,BHAGYA NAGAR,1,45,4,1,22,73
UTTAR PRADESH,AURAIYA,BIDHUNA,9,39,2,0,33,83
UTTAR PRADESH,AURAIYA,SAHAR,8,41,6,2,0,57
UTTAR PRADESH,AZAMGARH,AHIROLA,0,2,6,0,2,10
UTTAR PRADESH,AZAMGARH,ATROULIA,3,2,23,0,3,31
UTTAR PRADESH,AZAMGARH,AZAMATGARH,12,14,26,0,4,56
UTTAR PRADESH,AZAMGARH,BILARIYA,0,0,9,2,18,29
UTTAR PRADESH,AZAMGARH,HARIYA,1,13,9,12,20,55
UTTAR PRADESH,AZAMGARH,JAHANA GANJ,1,2,0,5,5,13
UTTAR PRADESH,AZAMGARH,KOAILSA,12,3,0,1,0,16
UTTAR PRADESH,AZAMGARH,LALGANJ,0,0,0,0,1,1
UTTAR PRADESH,AZAMGARH,MAHARAJGANJ,15,3,0,9,25,52
UTTAR PRADESH,AZAMGARH,MARTINGANJ,0,0,0,1,0,1
UTTAR PRADESH,AZAMGARH,MEHNAGAR,0,0,0,2,1,3
UTTAR PRADESH,AZAMGARH,MIRZA PUR,6,0,0,0,1,7
UTTAR PRADESH,AZAMGARH,MOHAMMADPUR,0,0,7,0,0,7
UTTAR PRADESH,AZAMGARH,PALHANI,3,0,15,0,0,18
UTTAR PRADESH,AZAMGARH,PAWAI,0,1,3,7,0,11
UTTAR PRADESH,AZAMGARH,RANI KI SARAI,12,1,0,0,0,13
UTTAR PRADESH,AZAMGARH,SANTHIYANUA,1,15,7,0,15,38
UTTAR PRADESH,AZAMGARH,TAHAUWARPUR,2,1,0,0,0,3
UTTAR PRADESH,AZAMGARH,TARAWA,0,1,4,0,4,9
UTTAR PRADESH,AZAMGARH,THEKAMA,0,7,0,2,3,12
UTTAR PRADESH,BAGHPAT,BADRAUT,122,17,0,0,0,139
UTTAR PRADESH,BAGHPAT,BAGHPAT,0,21,0,0,0,21
UTTAR PRADESH,BAGHPAT,BINAULI,159,67,0,0,40,266
UTTAR PRADESH,BAGHPAT,CHHAPRAULI,0,0,0,0,1,1
UTTAR PRADESH,BAGHPAT,KHEKRA,1,34,0,0,0,35
UTTAR PRADESH,BAGHPAT,PILANA,4,54,0,0,0,58
UTTAR PRADESH,BAHARAICH,BALHA,2,39,1,0,1,43
UTTAR PRADESH,BAHARAICH,CHITTAURA,0,46,2,11,16,75
UTTAR PRADESH,BAHARAICH,Fakharpur,0,20,0,0,0,20
UTTAR PRADESH,BAHARAICH,HUJURPUR,0,23,0,0,0,23
UTTAR PRADESH,BAHARAICH,JARVAL,0,50,1,0,0,51
UTTAR PRADESH,BAHARAICH,KAISHARGANJ,5,26,0,0,3,34
UTTAR PRADESH,BAHARAICH,MAHASHI,0,11,0,0,0,11
UTTAR PRADESH,BAHARAICH,MIHIPURWA,0,83,0,0,0,83
UTTAR PRADESH,BAHARAICH,NAWABGANJ,0,1,4,0,0,5
UTTAR PRADESH,BAHARAICH,PAYAG PUR,0,1,0,0,0,1
UTTAR PRADESH,BAHARAICH,RISHYA,0,116,0,0,0,116
UTTAR PRADESH,BAHARAICH,SHIVPUR,2,18,0,0,0,20
UTTAR PRADESH,BAHARAICH,TAJAWAPUR,0,27,0,0,1,28
UTTAR PRADESH,BAHARAICH,VISHESHAR GANJ,0,9,0,0,0,9
UTTAR PRADESH,BALLIA,BAIRIA,4,6,0,24,2,36
UTTAR PRADESH,BALLIA,BANSDEEH,8,38,0,15,4,65
UTTAR PRADESH,BALLIA,BELHARI,11,19,0,11,13,54
UTTAR PRADESH,BALLIA,BERUARBARI,5,17,0,4,8,34
UTTAR PRADESH,BALLIA,CHILKHAR,27,69,2,24,9,131
UTTAR PRADESH,BALLIA,DUBHAR,6,30,0,31,5,72
UTTAR PRADESH,BALLIA,GARWARH,7,20,1,15,8,51
UTTAR PRADESH,BALLIA,HANUMANGANJ,1,15,1,25,4,46
UTTAR PRADESH,BALLIA,MANIER,1,43,0,16,8,68
UTTAR PRADESH,BALLIA,MURLICHAPRA,2,8,0,5,3,18
UTTAR PRADESH,BALLIA,NAGRA,14,77,0,60,2,153
UTTAR PRADESH,BALLIA,NAWANAGAR,6,34,0,19,0,59
UTTAR PRADESH,BALLIA,PANDAH,6,33,1,17,3,60
UTTAR PRADESH,BALLIA,RASRA,16,74,5,25,15,135
UTTAR PRADESH,BALLIA,REVOTI,6,72,0,21,3,102
UTTAR PRADESH,BALLIA,SEAR,3,45,2,29,4,83
UTTAR PRADESH,BALLIA,SOHAON,3,21,0,17,6,47
UTTAR PRADESH,BALRAMPUR,BALRAMPUR,25,123,0,2,1,151
UTTAR PRADESH,BALRAMPUR,GAISADI,0,21,0,0,0,21
UTTAR PRADESH,BALRAMPUR,GANDAS BUJURG,2,2,0,0,0,4
UTTAR PRADESH,BALRAMPUR,HARRAIYA SATGHARWA,4,23,5,3,0,35
UTTAR PRADESH,BALRAMPUR,PACHAPEDWA,3,10,0,0,0,13
UTTAR PRADESH,BALRAMPUR,REHARA BAZAR,13,6,1,0,1,21
UTTAR PRADESH,BALRAMPUR,SHRI DATTGANJ,7,33,7,0,2,49
UTTAR PRADESH,BALRAMPUR,TULSIPUR,2,39,1,3,9,54
UTTAR PRADESH,BALRAMPUR,UTRAULA,0,54,0,0,0,54
UTTAR PRADESH,BANDA,BABERU,35,80,6,2,2,125
UTTAR PRADESH,BANDA,BADOKHAR KHURD,54,53,15,1,12,135
UTTAR PRADESH,BANDA,BISANDA,5,2,0,0,7,14
UTTAR PRADESH,BANDA,JASPURA,0,108,65,6,7,186
UTTAR PRADESH,BANDA,KAMASIN,53,13,1,1,0,68
UTTAR PRADESH,BANDA,MAHUA,5,6,1,0,8,20
UTTAR PRADESH,BANDA,NARAINI,8,2,3,0,0,13
UTTAR PRADESH,BANDA,TINDWARI,157,268,305,9,120,859
UTTAR PRADESH,BARABANKI,BANIKODAR,7,1,8,0,0,16
UTTAR PRADESH,BARABANKI,BANKI,3,0,5,0,0,8
UTTAR PRADESH,BARABANKI,DARIYABAD,0,1,2,0,0,3
UTTAR PRADESH,BARABANKI,DEVA,2,2,0,0,0,4
UTTAR PRADESH,BARABANKI,FATEHPUR,8,5,0,10,2,25
UTTAR PRADESH,BARABANKI,HAIDARGARH,0,5,0,0,0,5
UTTAR PRADESH,BARABANKI,HARKHA,2,5,1,7,0,15
UTTAR PRADESH,BARABANKI,MASAULI,4,1,1,0,0,6
UTTAR PRADESH,BARABANKI,NINDURA,20,5,26,0,2,53
UTTAR PRADESH,BARABANKI,PUREDALAI,24,5,10,4,1,44
UTTAR PRADESH,BARABANKI,RAMNAGAR,1,0,17,1,0,19
UTTAR PRADESH,BARABANKI,SIDHOUR,15,3,2,0,0,20
UTTAR PRADESH,BARABANKI,SIROULIGAUSPUR,6,11,1,12,0,30
UTTAR PRADESH,BARABANKI,SURATGANJ,0,4,24,0,1,29
UTTAR PRADESH,BARABANKI,TRIVEDIGANJ,1,2,0,0,0,3
UTTAR PRADESH,BAREILLY,AALAMPUR JAFARABAD,13,20,6,0,4,43
UTTAR PRADESH,BAREILLY,BAHERI,22,7,234,16,11,290
UTTAR PRADESH,BAREILLY,BHADPURA,0,4,0,0,0,4
UTTAR PRADESH,BAREILLY,BHOJIPURA,1,3,7,1,2,14
UTTAR PRADESH,BAREILLY,BHUTA,16,12,1,0,0,29
UTTAR PRADESH,BAREILLY,BITHIRI CHAINPUR,0,3,0,0,1,4
UTTAR PRADESH,BAREILLY,FARIDPUR,10,20,0,0,0,30
UTTAR PRADESH,BAREILLY,FATEHGANJ (W),37,11,29,1,2,80
UTTAR PRADESH,BAREILLY,KYARA,1,2,6,3,2,14
UTTAR PRADESH,BAREILLY,MAJHGAWAN,7,12,13,1,28,61
UTTAR PRADESH,BAREILLY,MIRGANJ,19,31,11,18,1,80
UTTAR PRADESH,BAREILLY,NAWABGANJ,4,8,20,0,1,33
UTTAR PRADESH,BAREILLY,RAM NAGAR,10,21,44,0,6,81
UTTAR PRADESH,BAREILLY,RICHHA,2,3,8,0,0,13
UTTAR PRADESH,BAREILLY,SHERGARH,0,1,3,0,1,5
UTTAR PRADESH,BASTI,BAHADURPUR,3,10,0,12,0,25
UTTAR PRADESH,BASTI,BANKATI,5,103,1,4,1,114
UTTAR PRADESH,BASTI,BASTI SADAR,6,22,3,36,9,76
UTTAR PRADESH,BASTI,DUBAULIYA,0,3,0,0,2,5
UTTAR PRADESH,BASTI,GAUR,1,20,0,27,0,48
UTTAR PRADESH,BASTI,HARRAIYA,2,12,0,18,2,34
UTTAR PRADESH,BASTI,KAPTAN GANJ,7,12,0,38,2,59
UTTAR PRADESH,BASTI,KUDRAHA,0,2,0,22,0,24
UTTAR PRADESH,BASTI,PARASH RAMPUR,2,9,0,8,0,19
UTTAR PRADESH,BASTI,RAM NAGAR,15,2,0,48,3,68
UTTAR PRADESH,BASTI,RUDHAULI,32,154,2,1,3,192
UTTAR PRADESH,BASTI,SAHUGHAT,13,8,2,7,1,31
UTTAR PRADESH,BASTI,SALTAUWA GOPALPUR,4,15,0,32,4,55
UTTAR PRADESH,BASTI,VIKRAMJOT,4,20,0,4,0,28
UTTAR PRADESH,BIJNOR,AAKU NEHTOUR,1,53,0,0,0,54
UTTAR PRADESH,BIJNOR,AFJALGARH,0,15,0,2,4,21
UTTAR PRADESH,BIJNOR,ALLEHEPUR DHAMPUR,2,76,2,0,0,80
UTTAR PRADESH,BIJNOR,BUDHANPUR SEOHARA,6,63,0,0,0,69
UTTAR PRADESH,BIJNOR,HALDOUR,1,78,0,0,0,79
UTTAR PRADESH,BIJNOR,JALILPUR,0,101,0,0,0,101
UTTAR PRADESH,BIJNOR,KIRATPUR,21,74,0,1,0,96
UTTAR PRADESH,BIJNOR,KOTWALI,21,83,0,0,0,104
UTTAR PRADESH,BIJNOR,MOHD.PUR DEVMAL,2,54,0,1,1,58
UTTAR PRADESH,BIJNOR,NAJIBABAD,3,47,2,0,3,55
UTTAR PRADESH,BIJNOR,NOORPUR,2,81,0,0,0,83
UTTAR PRADESH,BUDAUN,AMBIYAPUR,5,94,4,0,3,106
UTTAR PRADESH,BUDAUN,ASAFPUR,15,78,7,0,0,100
UTTAR PRADESH,BUDAUN,BISAULI,3,81,9,0,1,94
UTTAR PRADESH,BUDAUN,DATAGANJ,7,5,0,0,6,18
UTTAR PRADESH,BUDAUN,DEHGWA,5,6,0,0,0,11
UTTAR PRADESH,BUDAUN,GUNNAUR,14,14,1,0,1,30
UTTAR PRADESH,BUDAUN,ISLAMNAGAR,13,54,3,0,0,70
UTTAR PRADESH,BUDAUN,JAGAT,16,29,32,11,5,93
UTTAR PRADESH,BUDAUN,JUNAMAI,2,14,1,3,5,25
UTTAR PRADESH,BUDAUN,KADAR CHOKE,1,16,12,3,2,34
UTTAR PRADESH,BUDAUN,MYAUN,2,13,8,26,18,67
UTTAR PRADESH,BUDAUN,RAJPURA,10,11,1,2,0,24
UTTAR PRADESH,BUDAUN,SAHASWAN,2,25,9,0,1,37
UTTAR PRADESH,BUDAUN,SALARPUR,10,40,4,1,0,55
UTTAR PRADESH,BUDAUN,SAMRAR,3,3,0,0,1,7
UTTAR PRADESH,BUDAUN,UJHANI,6,28,6,0,8,48
UTTAR PRADESH,BUDAUN,USAWA,1,5,9,6,0,21
UTTAR PRADESH,BUDAUN,WAZIRGANJ,18,72,4,0,0,94
UTTAR PRADESH,BULAND SAHAR,ANUPSHAHR,1,31,2,1,0,35
UTTAR PRADESH,BULAND SAHAR,B.B. NAGAR,0,10,0,0,1,11
UTTAR PRADESH,BULAND SAHAR,BULANDSHAHR,2,18,0,0,0,20
UTTAR PRADESH,BULAND SAHAR,DANPUR,5,57,1,1,0,64
UTTAR PRADESH,BULAND SAHAR,DIBAI,1,6,0,0,0,7
UTTAR PRADESH,BULAND SAHAR,GULAWATHI,0,5,0,1,0,6
UTTAR PRADESH,BULAND SAHAR,JAHAGIRABAD,9,21,0,0,0,30
UTTAR PRADESH,BULAND SAHAR,KHURJA,1,11,0,0,0,12
UTTAR PRADESH,BULAND SAHAR,LAKHAWATI,2,19,2,0,0,23
UTTAR PRADESH,BULAND SAHAR,PAHASU,6,29,0,0,0,35
UTTAR PRADESH,BULAND SAHAR,SHIKARPUR,4,31,0,0,0,35
UTTAR PRADESH,BULAND SAHAR,SIKANDRABAD,4,43,0,0,0,47
UTTAR PRADESH,BULAND SAHAR,UNCHAGAON,0,20,0,0,0,20
UTTAR PRADESH,CHANDAULI,BARAHNI,3,7,0,0,0,10
UTTAR PRADESH,CHANDAULI,CHAHANIA,0,5,0,2,1,8
UTTAR PRADESH,CHANDAULI,CHAKIYA,76,23,1,0,5,105
UTTAR PRADESH,CHANDAULI,CHANDOULI,0,19,0,0,0,19
UTTAR PRADESH,CHANDAULI,DHANAPUR,2,12,0,4,0,18
UTTAR PRADESH,CHANDAULI,NAOUGHAR,3,11,0,0,0,14
UTTAR PRADESH,CHANDAULI,NIYMATA BAD,5,9,6,4,13,37
UTTAR PRADESH,CHANDAULI,SAHABGANJ,0,9,1,0,0,10
UTTAR PRADESH,CHANDAULI,SAKELDIHA,10,12,8,31,9,70
UTTAR PRADESH,CHITRAKOOT,KARVI,5,3,9,0,23,40
UTTAR PRADESH,CHITRAKOOT,MANIKPUR,2,0,0,0,2,4
UTTAR PRADESH,CHITRAKOOT,MAU,34,9,0,0,0,43
UTTAR PRADESH,CHITRAKOOT,PAHADI,0,0,0,1,0,1
UTTAR PRADESH,CHITRAKOOT,RAM NAGAR,5,92,6,2,1,106
UTTAR PRADESH,DEORIA,BAITALPUR,18,31,1,23,13,86
UTTAR PRADESH,DEORIA,BANKATA,17,21,1,27,4,70
UTTAR PRADESH,DEORIA,BARHAJ,17,24,2,19,1,63
UTTAR PRADESH,DEORIA,BHAGALPUR,10,58,3,1,1,73
UTTAR PRADESH,DEORIA,BHALUWANI,48,94,1,12,0,155
UTTAR PRADESH,DEORIA,BHATANI,7,28,3,19,3,60
UTTAR PRADESH,DEORIA,BHATPAR RANI,45,8,0,12,6,71
UTTAR PRADESH,DEORIA,DEORIA SADAR,23,46,3,33,4,109
UTTAR PRADESH,DEORIA,DESAHI DEORIA,0,17,0,0,0,17
UTTAR PRADESH,DEORIA,GAURI BAZAR,30,17,2,22,5,76
UTTAR PRADESH,DEORIA,LAR,37,16,0,5,1,59
UTTAR PRADESH,DEORIA,PATHARDEVA,7,22,0,0,0,29
UTTAR PRADESH,DEORIA,RAMPUR KARKHANA,6,12,1,0,2,21
UTTAR PRADESH,DEORIA,RUDRAPUR,5,17,3,12,1,38
UTTAR PRADESH,DEORIA,SALEMPUR,29,36,11,30,9,115
UTTAR PRADESH,DEORIA,TARKULWA,0,1,0,0,0,1
UTTAR PRADESH,ETAH,ALIGANJ,0,92,0,0,0,92
UTTAR PRADESH,ETAH,AMAPUR,0,29,0,0,0,29
UTTAR PRADESH,ETAH,AWAGARH,1,22,0,0,0,23
UTTAR PRADESH,ETAH,GANJDUNDWARA,0,57,0,0,0,57
UTTAR PRADESH,ETAH,JAIDHRA,0,69,0,0,0,69
UTTAR PRADESH,ETAH,JALESAR,1,4,0,0,0,5
UTTAR PRADESH,ETAH,KASGANJ,0,59,1,0,2,62
UTTAR PRADESH,ETAH,MARAHERA,0,52,0,0,0,52
UTTAR PRADESH,ETAH,NIDHOLI KALAN,0,51,0,0,0,51
UTTAR PRADESH,ETAH,PATIYALI,0,57,0,1,1,59
UTTAR PRADESH,ETAH,SAHAWAR,0,44,0,0,5,49
UTTAR PRADESH,ETAH,SAKIT,0,42,0,0,0,42
UTTAR PRADESH,ETAH,SHEETALPUR,0,47,0,2,0,49
UTTAR PRADESH,ETAH,SIDHPURA,0,15,0,0,2,17
UTTAR PRADESH,ETAH,SORON,0,95,0,0,0,95
UTTAR PRADESH,ETAWAH,BADPURA,8,16,0,5,62,91
UTTAR PRADESH,ETAWAH,BASREHAR,0,31,0,0,36,67
UTTAR PRADESH,ETAWAH,BHARTHANA,0,28,0,3,92,123
UTTAR PRADESH,ETAWAH,CHAKARNAGAR,0,2,0,0,0,2
UTTAR PRADESH,ETAWAH,JASWANT NAGAR,7,16,0,0,48,71
UTTAR PRADESH,ETAWAH,MAHEWA,15,67,0,0,64,146
UTTAR PRADESH,ETAWAH,SAIPHAI,0,7,0,0,0,7
UTTAR PRADESH,ETAWAH,TAKHA,1,41,0,0,37,79
UTTAR PRADESH,FAIZABAD,AMANI GANJ,19,21,5,9,22,76
UTTAR PRADESH,FAIZABAD,BIKAPUR,10,19,5,8,41,83
UTTAR PRADESH,FAIZABAD,HASTINPUR,21,60,6,7,43,137
UTTAR PRADESH,FAIZABAD,MASONDHA,1,9,2,1,8,21
UTTAR PRADESH,FAIZABAD,MAWAI,12,54,3,8,31,108
UTTAR PRADESH,FAIZABAD,MAYA,1,3,3,0,7,14
UTTAR PRADESH,FAIZABAD,MILKI PUR,8,9,4,4,18,43
UTTAR PRADESH,FAIZABAD,PURA,1,3,0,0,7,11
UTTAR PRADESH,FAIZABAD,RUDAULI,10,48,5,0,21,84
UTTAR PRADESH,FAIZABAD,SOHAWAL,11,38,3,3,26,81
UTTAR PRADESH,FAIZABAD,TARUN,12,81,6,4,58,161
UTTAR PRADESH,FARRUKHABAD,BARHPUR,1,5,19,0,0,25
UTTAR PRADESH,FARRUKHABAD,KAMALGANJ,13,25,36,6,24,104
UTTAR PRADESH,FARRUKHABAD,KAYAMGANJ,0,31,46,0,0,77
UTTAR PRADESH,FARRUKHABAD,MOHAMDABAD,11,38,11,22,73,155
UTTAR PRADESH,FARRUKHABAD,NAWABGANJ,0,14,22,0,0,36
UTTAR PRADESH,FARRUKHABAD,RAJEPUR,0,8,6,0,0,14
UTTAR PRADESH,FARRUKHABAD,SHAMSHABAD,0,9,20,0,1,30
UTTAR PRADESH,FATEHPUR,AIRAYA,17,9,0,2,5,33
UTTAR PRADESH,FATEHPUR,AMAULI,211,248,90,63,20,632
UTTAR PRADESH,FATEHPUR,ASODHAR,4,28,22,9,1,64
UTTAR PRADESH,FATEHPUR,BAHUWA,32,14,1,2,0,49
UTTAR PRADESH,FATEHPUR,BHITAURA,7,11,0,0,1,19
UTTAR PRADESH,FATEHPUR,DEVMAI,54,1,1,5,0,61
UTTAR PRADESH,FATEHPUR,DHATA,58,10,0,0,0,68
UTTAR PRADESH,FATEHPUR,HASWA,52,74,6,1,0,133
UTTAR PRADESH,FATEHPUR,HATHGAON,12,2,0,0,0,14
UTTAR PRADESH,FATEHPUR,KHAJUHA,17,43,2,1,1,64
UTTAR PRADESH,FATEHPUR,MALWAN,28,69,4,1,6,108
UTTAR PRADESH,FATEHPUR,TELYANI,19,0,1,1,0,21
UTTAR PRADESH,FATEHPUR,VIJAYIPUR,99,117,53,0,3,272
UTTAR PRADESH,FIROZABAD,EKA,1,2,1,0,0,4
UTTAR PRADESH,FIROZABAD,FIROZABAD,5,8,0,1,1,15
UTTAR PRADESH,FIROZABAD,JASRANA,0,7,0,0,0,7
UTTAR PRADESH,FIROZABAD,KHAIRGARH,8,19,0,0,2,29
UTTAR PRADESH,FIROZABAD,KOTLA NARKHI,55,92,0,0,1,148
UTTAR PRADESH,FIROZABAD,MADANPUR,136,25,2,0,0,163
UTTAR PRADESH,FIROZABAD,ORAON,1,39,0,0,5,45
UTTAR PRADESH,FIROZABAD,SHIKOHABAD,3,20,4,5,0,32
UTTAR PRADESH,FIROZABAD,TUNDLA,45,49,9,0,1,104
UTTAR PRADESH,GAUTAM BUDHA NAGAR,BISRAKH,13,10,2,0,0,25
UTTAR PRADESH,GAUTAM BUDHA NAGAR,DADRI,4,12,8,0,0,24
UTTAR PRADESH,GAUTAM BUDHA NAGAR,DANKAOR,7,29,21,0,0,57
UTTAR PRADESH,GAUTAM BUDHA NAGAR,JEWAR,23,34,4,1,0,62
UTTAR PRADESH,GHAZIABAD,BHOJPUR,5,16,1,0,0,22
UTTAR PRADESH,GHAZIABAD,DHAULANA,13,11,0,0,0,24
UTTAR PRADESH,GHAZIABAD,GARH MUKTESWAR,5,34,0,1,1,41
UTTAR PRADESH,GHAZIABAD,HAPUR,19,26,0,1,2,48
UTTAR PRADESH,GHAZIABAD,LAUNI,4,14,0,1,0,19
UTTAR PRADESH,GHAZIABAD,MURADNAGAR,0,24,0,0,0,24
UTTAR PRADESH,GHAZIABAD,RAJPUR,5,12,1,0,1,19
UTTAR PRADESH,GHAZIABAD,SIMBHAWALI,8,11,0,0,0,19
UTTAR PRADESH,GHAZIPUR,BARACHAWAR,4,9,2,1,12,28
UTTAR PRADESH,GHAZIPUR,BHADORA,5,6,0,3,16,30
UTTAR PRADESH,GHAZIPUR,BHANWARKOL,40,9,25,3,26,103
UTTAR PRADESH,GHAZIPUR,DEVKALI,37,4,19,0,1,61
UTTAR PRADESH,GHAZIPUR,JAMANIYA,3,6,1,1,12,23
UTTAR PRADESH,GHAZIPUR,KARNDA,1,3,50,0,0,54
UTTAR PRADESH,GHAZIPUR,KASIMABAD,3,3,1,0,10,17
UTTAR PRADESH,GHAZIPUR,MANIHARI,9,0,0,2,21,32
UTTAR PRADESH,GHAZIPUR,MARADAH,3,3,3,11,8,28
UTTAR PRADESH,GHAZIPUR,MOHMMADABAD,1,0,84,0,2,87
UTTAR PRADESH,GHAZIPUR,REVTIPUR,0,0,40,1,5,46
UTTAR PRADESH,GHAZIPUR,SADAR,3,14,42,2,33,94
UTTAR PRADESH,GHAZIPUR,SADAT,8,4,1,7,3,23
UTTAR PRADESH,GHAZIPUR,SAIDPUR,12,16,35,1,17,81
UTTAR PRADESH,GHAZIPUR,VIRNO,6,4,1,5,16,32
UTTAR PRADESH,GHAZIPUR,ZAKHANIA,8,4,0,8,21,41
UTTAR PRADESH,GONDA,BELSAR,3,9,5,0,0,17
UTTAR PRADESH,GONDA,BHABHANJOT,2,10,0,1,2,15
UTTAR PRADESH,GONDA,CHHAPIA,0,7,0,0,0,7
UTTAR PRADESH,GONDA,COLONELGANJ,0,1,0,0,0,1
UTTAR PRADESH,GONDA,HALDAR MAU,7,3,0,0,2,12
UTTAR PRADESH,GONDA,ITIYATHOK,10,58,2,1,3,74
UTTAR PRADESH,GONDA,JHANJHRI,3,13,0,0,2,18
UTTAR PRADESH,GONDA,KATRA BAZAR,98,0,0,0,0,98
UTTAR PRADESH,GONDA,MANKAPUR,1,75,0,0,2,78
UTTAR PRADESH,GONDA,MUJEHNA,4,28,2,2,1,37
UTTAR PRADESH,GONDA,NAWABGANJ,0,77,0,0,0,77
UTTAR PRADESH,GONDA,PANDRIKRIPAL,2,30,0,1,15,48
UTTAR PRADESH,GONDA,PARASPUR,2,7,0,1,0,10
UTTAR PRADESH,GONDA,RUPIHDEEH,11,113,5,13,0,142
UTTAR PRADESH,GONDA,TARABGANJ,0,31,1,2,0,34
UTTAR PRADESH,GONDA,WAZIRGANJ,0,12,0,0,1,13
UTTAR PRADESH,GORAKHPUR,BANSGAON,13,11,48,20,6,98
UTTAR PRADESH,GORAKHPUR,BARAHALGANJ,0,3,0,12,4,19
UTTAR PRADESH,GORAKHPUR,BELGHAT,11,20,5,16,4,56
UTTAR PRADESH,GORAKHPUR,BHATHAT,1,8,17,5,4,35
UTTAR PRADESH,GORAKHPUR,BRAHMPUR,3,3,45,21,5,77
UTTAR PRADESH,GORAKHPUR,CAMPIARGANJ,1,30,10,19,95,155
UTTAR PRADESH,GORAKHPUR,CHARGANWA,0,5,17,11,4,37
UTTAR PRADESH,GORAKHPUR,GAGHA,1,3,14,50,6,74
UTTAR PRADESH,GORAKHPUR,GOLA,11,6,0,32,13,62
UTTAR PRADESH,GORAKHPUR,JANGAL KAURIA,4,10,72,20,12,118
UTTAR PRADESH,GORAKHPUR,KAURIRAM,1,4,32,31,0,68
UTTAR PRADESH,GORAKHPUR,KHAJANI,13,2,89,0,85,189
UTTAR PRADESH,GORAKHPUR,KHORABAR,17,5,34,9,0,65
UTTAR PRADESH,GORAKHPUR,PALI,0,4,42,42,3,91
UTTAR PRADESH,GORAKHPUR,PIPRAICH,3,4,26,6,2,41
UTTAR PRADESH,GORAKHPUR,PIPRAULI,2,44,65,2,30,143
UTTAR PRADESH,GORAKHPUR,SAHJANWA,4,8,71,3,28,114
UTTAR PRADESH,GORAKHPUR,SARDARNAGAR,0,33,24,1,11,69
UTTAR PRADESH,GORAKHPUR,URUWA,8,14,70,24,27,143
UTTAR PRADESH,HAMIRPUR,GOHAND,304,11,0,0,1,316
UTTAR PRADESH,HAMIRPUR,KURARA,188,71,6,0,1,266
UTTAR PRADESH,HAMIRPUR,MAUDAHA,146,23,10,2,4,185
UTTAR PRADESH,HAMIRPUR,MUSKARA,176,9,0,1,0,186
UTTAR PRADESH,HAMIRPUR,SARILA,110,5,0,0,14,129
UTTAR PRADESH,HAMIRPUR,SUMREPUR,21,111,8,0,6,146
UTTAR PRADESH,HARDOI,AHIROURI,0,38,0,0,0,38
UTTAR PRADESH,HARDOI,BAVAN,0,81,0,0,0,81
UTTAR PRADESH,HARDOI,BHARAWAN,0,8,0,0,0,8
UTTAR PRADESH,HARDOI,BHARKHANI,0,122,0,0,0,122
UTTAR PRADESH,HARDOI,BILGRAM,27,85,0,0,0,112
UTTAR PRADESH,HARDOI,HARIYAWAN,0,75,0,0,0,75
UTTAR PRADESH,HARDOI,HARPALPUR,0,12,0,0,0,12
UTTAR PRADESH,HARDOI,KOTHAWAN,9,27,0,0,0,36
UTTAR PRADESH,HARDOI,MAHDHOGANJ,0,22,0,0,0,22
UTTAR PRADESH,HARDOI,MALLAWAN,0,13,0,0,0,13
UTTAR PRADESH,HARDOI,PIHANI,0,96,0,0,0,96
UTTAR PRADESH,HARDOI,SANDI,0,25,0,0,0,25
UTTAR PRADESH,HARDOI,SANDILA,1,5,0,0,0,6
UTTAR PRADESH,HARDOI,SHAHABAD,0,169,0,0,0,169
UTTAR PRADESH,HARDOI,SURSA,0,29,0,0,0,29
UTTAR PRADESH,HARDOI,TANDIYAWA,0,71,0,0,0,71
UTTAR PRADESH,HARDOI,TODARPUR,0,45,0,0,0,45
UTTAR PRADESH,JALAUN,DAKOR,142,147,3,1,0,293
UTTAR PRADESH,JALAUN,ETKONCH,134,74,0,4,3,215
UTTAR PRADESH,JALAUN,JALAUN,29,48,0,0,2,79
UTTAR PRADESH,JALAUN,KADAURA,97,68,0,2,2,169
UTTAR PRADESH,JALAUN,KUTHAUND,32,101,27,1,1,162
UTTAR PRADESH,JALAUN,MADHO GANJ,48,45,0,0,0,93
UTTAR PRADESH,JALAUN,MAHEBA,256,144,1,11,9,421
UTTAR PRADESH,JALAUN,NADIGAON,161,113,2,1,0,277
UTTAR PRADESH,JALAUN,RAMPURA,27,20,0,4,0,51
UTTAR PRADESH,JAUNPUR,BADLA PUR,0,1,0,0,1,2
UTTAR PRADESH,JAUNPUR,BAKSHA,2,9,0,1,4,16
UTTAR PRADESH,JAUNPUR,BARSOTHI,2,28,0,4,27,61
UTTAR PRADESH,JAUNPUR,DHARMA PUR,2,0,0,0,2,4
UTTAR PRADESH,JAUNPUR,DOBHI,0,21,0,3,26,50
UTTAR PRADESH,JAUNPUR,JALAL PUR,0,20,0,3,29,52
UTTAR PRADESH,JAUNPUR,KARNJAKALA,0,4,0,1,15,20
UTTAR PRADESH,JAUNPUR,KERAKAT,0,13,2,2,29,46
UTTAR PRADESH,JAUNPUR,KHUTHAN,3,20,0,3,40,66
UTTAR PRADESH,JAUNPUR,M.SHAHAR,0,17,0,2,41,60
UTTAR PRADESH,JAUNPUR,MADRIYAHU,11,4,0,1,10,26
UTTAR PRADESH,JAUNPUR,MUFTI GANJ,0,12,0,2,27,41
UTTAR PRADESH,JAUNPUR,MUGLA BADSHAH PUR,2,30,0,4,53,89
UTTAR PRADESH,JAUNPUR,RAM NAGAR,2,16,0,2,24,44
UTTAR PRADESH,JAUNPUR,RAMPUR,4,29,0,5,34,72
UTTAR PRADESH,JAUNPUR,SHAH GANJ,0,1,0,1,10,12
UTTAR PRADESH,JAUNPUR,SIKRARA,13,9,0,1,13,36
UTTAR PRADESH,JAUNPUR,SIRKONI,2,19,0,3,21,45
UTTAR PRADESH,JAUNPUR,SUITHA KALA,3,18,0,7,45,73
UTTAR PRADESH,JAUNPUR,SUJAN GANJ,4,2,0,0,3,9
UTTAR PRADESH,JHANSI,BABINA,13,18,0,0,0,31
UTTAR PRADESH,JHANSI,BADAGAON,24,6,0,0,0,30
UTTAR PRADESH,JHANSI,BAMAUR,16,41,0,0,0,57
UTTAR PRADESH,JHANSI,BANGRA,25,21,0,0,0,46
UTTAR PRADESH,JHANSI,CHIRGAON,29,22,0,0,0,51
UTTAR PRADESH,JHANSI,GURSARAI,16,10,2,5,1,34
UTTAR PRADESH,JHANSI,MAURANIPUR,36,50,0,0,1,87
UTTAR PRADESH,JHANSI,MOTH,49,18,1,0,5,73
UTTAR PRADESH,JYOTIBA PHULENAGAR,AMROHA,17,64,0,0,0,81
UTTAR PRADESH,JYOTIBA PHULENAGAR,DHANORA,20,33,8,1,0,62
UTTAR PRADESH,JYOTIBA PHULENAGAR,GAJROLA,14,5,0,0,0,19
UTTAR PRADESH,JYOTIBA PHULENAGAR,GANGESHWARI,0,12,99,2,0,113
UTTAR PRADESH,JYOTIBA PHULENAGAR,HASANPUR,22,52,6,0,0,80
UTTAR PRADESH,JYOTIBA PHULENAGAR,JOYA,23,15,0,0,0,38
UTTAR PRADESH,KANNAUJ,CHHIBRAMAU,6,4,9,13,27,59
UTTAR PRADESH,KANNAUJ,HASERAN,0,0,0,0,4,4
UTTAR PRADESH,KANNAUJ,JALABAD,0,2,34,0,8,44
UTTAR PRADESH,KANNAUJ,KANNAUJ,1,4,6,10,40,61
UTTAR PRADESH,KANNAUJ,SAURIKH,0,1,6,0,0,7
UTTAR PRADESH,KANNAUJ,TALGRAM,25,9,36,0,0,70
UTTAR PRADESH,KANPUR DEHAT,AKBARPUR,5,19,1,3,18,46
UTTAR PRADESH,KANPUR DEHAT,AMRAUDHA,204,88,64,1,16,373
UTTAR PRADESH,KANPUR DEHAT,DERAPUR,14,48,0,10,1,73
UTTAR PRADESH,KANPUR DEHAT,JHINJHAK,37,23,6,3,4,73
UTTAR PRADESH,KANPUR DEHAT,MAITHA,1,0,0,0,2,3
UTTAR PRADESH,KANPUR DEHAT,MALASA,67,309,57,7,4,444
UTTAR PRADESH,KANPUR DEHAT,RAJPUR,28,48,11,1,3,91
UTTAR PRADESH,KANPUR DEHAT,RASOOLABAD,2,10,0,0,0,12
UTTAR PRADESH,KANPUR DEHAT,SANDALPUR,3,5,6,1,5,20
UTTAR PRADESH,KANPUR DEHAT,SARVENKHERA,98,47,6,5,0,156
UTTAR PRADESH,KANPUR NAGAR,BILHAUR,0,22,8,0,0,30
UTTAR PRADESH,KANPUR NAGAR,BITARGAON,26,142,0,0,0,168
UTTAR PRADESH,KANPUR NAGAR,CHAMBEPUR,0,2,2,0,0,4
UTTAR PRADESH,KANPUR NAGAR,GHATAMPUR,23,134,621,5,11,794
UTTAR PRADESH,KANPUR NAGAR,KALYANPUR,0,12,0,0,0,12
UTTAR PRADESH,KANPUR NAGAR,PATARA,39,82,5,3,70,199
UTTAR PRADESH,KANPUR NAGAR,SARSAUL,3,27,2,0,1,33
UTTAR PRADESH,KANPUR NAGAR,SHIVRAJPUR,0,7,0,0,0,7
UTTAR PRADESH,KANPUR NAGAR,VIDHUNU,7,14,2,0,0,23
UTTAR PRADESH,KAUSHAMBI,CHAYAL,7,90,13,1,3,114
UTTAR PRADESH,KAUSHAMBI,KARA,1,7,3,3,25,39
UTTAR PRADESH,KAUSHAMBI,KOSHAMBHI,3,6,3,1,0,13
UTTAR PRADESH,KAUSHAMBI,MANJHANPUR,15,67,13,7,26,128
UTTAR PRADESH,KAUSHAMBI,MURATGANJ,19,159,6,9,21,214
UTTAR PRADESH,KAUSHAMBI,NEWADA,49,192,12,1,13,267
UTTAR PRADESH,KAUSHAMBI,SARSAWAN,2,8,0,0,0,10
UTTAR PRADESH,KAUSHAMBI,SIRATHU,15,166,391,256,39,867
UTTAR PRADESH,KHERI,BANKEYGANJ,0,0,18,0,0,18
UTTAR PRADESH,KHERI,BEHJAM,2,5,46,10,52,115
UTTAR PRADESH,KHERI,BIJUA,0,210,12,0,0,222
UTTAR PRADESH,KHERI,ISANAGAR,1,7,7,0,0,15
UTTAR PRADESH,KHERI,KHUMBHIGOLA,35,6,32,1,2,76
UTTAR PRADESH,KHERI,LAKHIMPUR,5,10,8,12,19,54
UTTAR PRADESH,KHERI,MITAULI,30,6,4,27,5,72
UTTAR PRADESH,KHERI,MOHAMMADI,38,27,9,110,8,192
UTTAR PRADESH,KHERI,NAKAHA,5,2,10,2,33,52
UTTAR PRADESH,KHERI,NIGHASAN,1,124,4,0,0,129
UTTAR PRADESH,KHERI,PALIA,2,23,29,0,0,54
UTTAR PRADESH,KHERI,PASGAWAN,21,37,1,58,20,137
UTTAR PRADESH,KHERI,PHOOLBEHAR,0,20,18,0,0,38
UTTAR PRADESH,KHERI,RAMIA BEHAR,0,4,0,0,0,4
UTTAR PRADESH,KUSHINAGAR,BISHUN PUR,0,7,0,0,4,11
UTTAR PRADESH,KUSHINAGAR,DUDAHI,2,13,0,0,0,15
UTTAR PRADESH,KUSHINAGAR,FAZIL NAGAR,3,6,0,5,0,14
UTTAR PRADESH,KUSHINAGAR,HATA,0,11,0,0,0,11
UTTAR PRADESH,KUSHINAGAR,KAPTAN GANJ,1,8,0,0,0,9
UTTAR PRADESH,KUSHINAGAR,KASAYA,0,21,0,0,0,21
UTTAR PRADESH,KUSHINAGAR,KHADDA,0,5,0,0,0,5
UTTAR PRADESH,KUSHINAGAR,MOTI CHAK,1,22,0,1,0,24
UTTAR PRADESH,KUSHINAGAR,NEBUAA NAORANGIYA,0,1,0,0,0,1
UTTAR PRADESH,KUSHINAGAR,PADRAUNA,1,22,2,0,4,29
UTTAR PRADESH,KUSHINAGAR,RAMKOLA,0,5,0,0,0,5
UTTAR PRADESH,KUSHINAGAR,SEVARI,2,1,0,0,1,4
UTTAR PRADESH,KUSHINAGAR,SHUKARAULI,0,12,0,0,0,12
UTTAR PRADESH,KUSHINAGAR,TAMAKUHI,1,11,4,0,1,17
UTTAR PRADESH,LALITPUR,BIRDHA,22,12,0,0,0,34
UTTAR PRADESH,LALITPUR,JAKHAURA,31,13,0,0,0,44
UTTAR PRADESH,LALITPUR,MANDAWARA,24,25,6,0,1,56
UTTAR PRADESH,LALITPUR,MEHRONI,20,7,0,0,1,28
UTTAR PRADESH,LUCKNOW,BAKSHI KA TALAB,6,22,0,0,3,31
UTTAR PRADESH,LUCKNOW,CHINHAT,5,7,0,1,2,15
UTTAR PRADESH,LUCKNOW,GOSAIGANJ,1,6,0,0,1,8
UTTAR PRADESH,LUCKNOW,KAKORI,6,14,6,0,0,26
UTTAR PRADESH,LUCKNOW,MALIHABAD,127,65,1,0,6,199
UTTAR PRADESH,LUCKNOW,MALL,17,24,1,0,4,46
UTTAR PRADESH,LUCKNOW,MOHANLALGANJ,5,24,1,0,1,31
UTTAR PRADESH,LUCKNOW,SAROJNINAGAR,29,18,0,0,4,51
UTTAR PRADESH,MAHA MAYA NAGAR,HASAYAN,4,15,0,0,0,19
UTTAR PRADESH,MAHA MAYA NAGAR,HATHRAS,1,15,0,0,0,16
UTTAR PRADESH,MAHA MAYA NAGAR,MURSAN,1,23,1,0,0,25
UTTAR PRADESH,MAHA MAYA NAGAR,SADABAD,1,0,0,0,0,1
UTTAR PRADESH,MAHA MAYA NAGAR,SAHPAU,0,16,0,0,0,16
UTTAR PRADESH,MAHA MAYA NAGAR,SASNI,5,33,1,3,1,43
UTTAR PRADESH,MAHA MAYA NAGAR,SIKANDRARAO,2,25,2,1,0,30
UTTAR PRADESH,MAHARAJ GANJ,BRIDGEMANGANJ,3,1,3,35,12,54
UTTAR PRADESH,MAHARAJ GANJ,DHANI,0,2,0,1,2,5
UTTAR PRADESH,MAHARAJ GANJ,GHUGHULI,0,5,0,4,0,9
UTTAR PRADESH,MAHARAJ GANJ,LAKSHMIPUR,0,10,0,9,0,19
UTTAR PRADESH,MAHARAJ GANJ,MAHRAJGANJ SADAR,0,14,0,1,0,15
UTTAR PRADESH,MAHARAJ GANJ,MITHAURA,0,5,0,0,0,5
UTTAR PRADESH,MAHARAJ GANJ,NAUTANAWA,0,17,1,15,0,33
UTTAR PRADESH,MAHARAJ GANJ,NICHLAUL,1,15,0,0,2,18
UTTAR PRADESH,MAHARAJ GANJ,PANIYARA,2,12,1,18,4,37
UTTAR PRADESH,MAHARAJ GANJ,PARTAWAL,0,5,2,2,0,9
UTTAR PRADESH,MAHARAJ GANJ,PHARENDA,2,21,0,19,31,73
UTTAR PRADESH,MAHARAJ GANJ,SISWA,0,3,0,1,0,4
UTTAR PRADESH,MAHOBA,CHARKHARI,27,10,0,0,0,37
UTTAR PRADESH,MAHOBA,KABARAI,52,76,0,3,11,142
UTTAR PRADESH,MAHOBA,PANWADI,3,9,0,0,0,12
UTTAR PRADESH,MAINPURI,BARNAHAL,3,44,5,0,0,52
UTTAR PRADESH,MAINPURI,BEWAR,0,21,0,0,0,21
UTTAR PRADESH,MAINPURI,GHIROR,0,33,5,3,0,41
UTTAR PRADESH,MAINPURI,JAGIR,1,24,0,0,1,26
UTTAR PRADESH,MAINPURI,KARHAL,1,34,0,0,0,35
UTTAR PRADESH,MAINPURI,KISHANI,0,22,1,0,0,23
UTTAR PRADESH,MAINPURI,KURAWALI,0,100,0,0,0,100
UTTAR PRADESH,MAINPURI,MAINPURI,8,129,1,0,0,138
UTTAR PRADESH,MAINPURI,SULTANGANJ,0,76,0,0,0,76
UTTAR PRADESH,MATHURA,BALDEV,3,0,0,0,0,3
UTTAR PRADESH,MATHURA,CHHATA,0,1,0,0,0,1
UTTAR PRADESH,MATHURA,CHOMUHA,1,1,0,0,0,2
UTTAR PRADESH,MATHURA,FARAH,4,5,1,0,0,10
UTTAR PRADESH,MATHURA,GOVERDHAN,0,1,0,0,0,1
UTTAR PRADESH,MATHURA,MAAT,1,2,0,0,0,3
UTTAR PRADESH,MATHURA,MATHURA,1,3,0,0,0,4
UTTAR PRADESH,MATHURA,NAND GAWON,0,1,0,0,0,1
UTTAR PRADESH,MATHURA,NOHJHIL,3,9,0,0,0,12
UTTAR PRADESH,MATHURA,RAYA,2,5,0,0,0,7
UTTAR PRADESH,MAU,BADRAW,0,0,20,14,7,41
UTTAR PRADESH,MAU,DOHARIGHAT,1,2,8,0,5,16
UTTAR PRADESH,MAU,FATEEHPUR MANDAVA,0,0,14,0,1,15
UTTAR PRADESH,MAU,GHOSI,1,1,10,0,4,16
UTTAR PRADESH,MAU,KOPAGANJ,0,2,19,0,11,32
UTTAR PRADESH,MAU,MUHAMMDABAD,3,2,31,1,10,47
UTTAR PRADESH,MAU,PARDHA,26,9,1,2,22,60
UTTAR PRADESH,MAU,RANIPUR,0,0,23,2,6,31
UTTAR PRADESH,MAU,RATANPURA,0,112,18,2,10,142
UTTAR PRADESH,MEERUT,DAURALA,0,16,0,0,0,16
UTTAR PRADESH,MEERUT,GEHTA,2,22,1,1,0,26
UTTAR PRADESH,MEERUT,HASTINAPUR,9,57,2,12,1,81
UTTAR PRADESH,MEERUT,JANI KHURD,3,8,0,0,0,11
UTTAR PRADESH,MEERUT,KHARKHODA,18,39,2,1,0,60
UTTAR PRADESH,MEERUT,MACHHRA,2,36,0,0,0,38
UTTAR PRADESH,MEERUT,MAWANA,1,5,0,0,0,6
UTTAR PRADESH,MEERUT,MEERUT,1,62,1,3,102,169
UTTAR PRADESH,MEERUT,PARIKSHITGARH,1,36,0,0,0,37
UTTAR PRADESH,MEERUT,RAJPURA,14,47,1,0,0,62
UTTAR PRADESH,MEERUT,SARDHANA,3,16,0,0,0,19
UTTAR PRADESH,MEERUT,SARURPUR KHURD,3,31,0,0,0,34
UTTAR PRADESH,MIRZAPUR,CHHANBEY,20,8,0,0,17,45
UTTAR PRADESH,MIRZAPUR,CITY,36,15,14,3,6,74
UTTAR PRADESH,MIRZAPUR,HALIYA,1,3,0,3,4,11
UTTAR PRADESH,MIRZAPUR,JAMALPUR,1,0,0,0,0,1
UTTAR PRADESH,MIRZAPUR,KONE,4,6,2,6,18,36
UTTAR PRADESH,MIRZAPUR,LALGANJ,7,9,6,9,0,31
UTTAR PRADESH,MIRZAPUR,MAJHWAN,52,108,57,3,1,221
UTTAR PRADESH,MIRZAPUR,MARIHAN,50,9,1,0,2,62
UTTAR PRADESH,MIRZAPUR,PAHARI,18,10,0,6,13,47
UTTAR PRADESH,MIRZAPUR,RAJGARH,1,1,0,0,0,2
UTTAR PRADESH,MORADABAD,ASMOLI,30,23,0,0,0,53
UTTAR PRADESH,MORADABAD,BAHJOI,54,49,20,2,2,127
UTTAR PRADESH,MORADABAD,BANIYA KHERA,2,95,22,1,0,120
UTTAR PRADESH,MORADABAD,BHAGATPUR TANDA,29,18,0,0,0,47
UTTAR PRADESH,MORADABAD,BILARI,13,139,1,1,0,154
UTTAR PRADESH,MORADABAD,BILARI-I,26,92,12,0,0,130
UTTAR PRADESH,MORADABAD,CHAILLAT,11,88,6,0,3,108
UTTAR PRADESH,MORADABAD,DINGPUR,14,78,9,0,6,107
UTTAR PRADESH,MORADABAD,MORADABAD,6,24,1,1,1,33
UTTAR PRADESH,MORADABAD,MUNDAPANDEY,31,12,0,0,0,43
UTTAR PRADESH,MORADABAD,PAWASA,51,4,1,0,0,56
UTTAR PRADESH,MORADABAD,SAMBHAL,100,28,2,0,0,130
UTTAR PRADESH,MORADABAD,THAKURDWARA,50,140,2,3,1,196
UTTAR PRADESH,MUZZAFARNAGAR,BAGHARA,13,24,1,0,1,39
UTTAR PRADESH,MUZZAFARNAGAR,BUDHANA,32,56,0,0,3,91
UTTAR PRADESH,MUZZAFARNAGAR,CHARTHAWAL,5,18,0,0,3,26
UTTAR PRADESH,MUZZAFARNAGAR,JANSATH,0,12,33,0,1,46
UTTAR PRADESH,MUZZAFARNAGAR,KAIRANA,30,17,0,8,0,55
UTTAR PRADESH,MUZZAFARNAGAR,KANDHLA,71,30,0,4,0,105
UTTAR PRADESH,MUZZAFARNAGAR,KHATOLI,0,14,6,14,2,36
UTTAR PRADESH,MUZZAFARNAGAR,MORNA,24,8,0,1,0,33
UTTAR PRADESH,MUZZAFARNAGAR,MUZAFFER NAGAR SADAR,0,7,0,3,1,11
UTTAR PRADESH,MUZZAFARNAGAR,PURKAZI,26,11,0,0,3,40
UTTAR PRADESH,MUZZAFARNAGAR,SHAHPUR,5,31,0,0,1,37
UTTAR PRADESH,MUZZAFARNAGAR,SHAMLI,85,13,1,4,2,105
UTTAR PRADESH,MUZZAFARNAGAR,THANA BHAVAN,86,3,4,0,1,94
UTTAR PRADESH,MUZZAFARNAGAR,UN,60,34,12,0,1,107
UTTAR PRADESH,PILIBHIT,AMREYA,0,81,0,0,0,81
UTTAR PRADESH,PILIBHIT,BERKHEDA,0,5,0,1,0,6
UTTAR PRADESH,PILIBHIT,BILSANDA,0,7,0,1,0,8
UTTAR PRADESH,PILIBHIT,BISALPUR,0,21,0,1,0,22
UTTAR PRADESH,PILIBHIT,LALORIKHEDA,0,7,0,1,0,8
UTTAR PRADESH,PILIBHIT,MARORI,0,44,1,1,0,46
UTTAR PRADESH,PILIBHIT,PURANPUR,0,8,0,0,0,8
UTTAR PRADESH,PRATAPGARH,AASPUR DEVSARA,0,15,0,0,0,15
UTTAR PRADESH,PRATAPGARH,BABA BELKHERNATH DHA,0,1,0,0,0,1
UTTAR PRADESH,PRATAPGARH,BABAGANJ,1,9,0,0,1,11
UTTAR PRADESH,PRATAPGARH,BIHAR,0,2,0,0,2,4
UTTAR PRADESH,PRATAPGARH,GAURA,0,6,1,0,8,15
UTTAR PRADESH,PRATAPGARH,KALAKANKAR,1,2,0,2,1,6
UTTAR PRADESH,PRATAPGARH,KUNDA,2,4,1,1,1,9
UTTAR PRADESH,PRATAPGARH,LAXMANPUR,1,0,0,0,1,2
UTTAR PRADESH,PRATAPGARH,MANDHATA,4,4,0,0,3,11
UTTAR PRADESH,PRATAPGARH,MANGRAURA,6,5,1,3,13,28
UTTAR PRADESH,PRATAPGARH,PATTI,0,3,1,0,0,4
UTTAR PRADESH,PRATAPGARH,RAMPUR-SANGRAMGARH.,2,0,0,0,1,3
UTTAR PRADESH,PRATAPGARH,RAMPUR KHAS,0,5,0,0,0,5
UTTAR PRADESH,PRATAPGARH,SADAR,1,4,0,0,4,9
UTTAR PRADESH,PRATAPGARH,SANDWA CHANDRIKA,4,2,1,0,8,15
UTTAR PRADESH,PRATAPGARH,SHIVGARH,2,1,2,0,7,12
UTTAR PRADESH,RAEBARELI,AMANWA,0,0,0,4,0,4
UTTAR PRADESH,RAEBARELI,BACHRAVAN,1,3,0,0,3,7
UTTAR PRADESH,RAEBARELI,BAHADUR PUR,0,1,0,1,0,2
UTTAR PRADESH,RAEBARELI,CHHATOH,0,0,0,0,4,4
UTTAR PRADESH,RAEBARELI,DALMAU,0,1,12,0,0,13
UTTAR PRADESH,RAEBARELI,DEEH,0,1,0,2,29,32
UTTAR PRADESH,RAEBARELI,HARCHANDPUR,0,2,2,5,0,9
UTTAR PRADESH,RAEBARELI,JAGAT PUR,0,0,3,0,2,5
UTTAR PRADESH,RAEBARELI,KHEERO,1,3,0,8,39,51
UTTAR PRADESH,RAEBARELI,LAL GANJ,64,5,44,0,0,113
UTTAR PRADESH,RAEBARELI,MAHARAJ GANJ,0,5,0,0,4,9
UTTAR PRADESH,RAEBARELI,RAHI,70,8,0,0,14,92
UTTAR PRADESH,RAEBARELI,ROHANIYA,0,1,0,0,2,3
UTTAR PRADESH,RAEBARELI,SALON,46,3,0,1,12,62
UTTAR PRADESH,RAEBARELI,SARANI,25,3,84,0,0,112
UTTAR PRADESH,RAEBARELI,SATAON,10,3,1,2,13,29
UTTAR PRADESH,RAEBARELI,SHIV GARH,0,7,1,0,3,11
UTTAR PRADESH,RAEBARELI,SINGHPUR,4,6,0,1,0,11
UTTAR PRADESH,RAEBARELI,TILOI,0,2,5,0,0,7
UTTAR PRADESH,RAEBARELI,UCHAHAR,3,4,32,0,0,39
UTTAR PRADESH,RAMPUR,BILASPUR,221,143,39,65,16,484
UTTAR PRADESH,RAMPUR,CHAMRAOA,16,13,1,0,0,30
UTTAR PRADESH,RAMPUR,MILAK,30,13,0,0,3,46
UTTAR PRADESH,RAMPUR,SAID NAGAR,10,27,6,0,0,43
UTTAR PRADESH,RAMPUR,SHAHABAD,2,121,4,1,1,129
UTTAR PRADESH,RAMPUR,SUAR,2,37,3,1,17,60
UTTAR PRADESH,SAHARANPUR,BALYA KHERI,10,45,1,6,1,63
UTTAR PRADESH,SAHARANPUR,DEOBAND,10,34,4,11,4,63
UTTAR PRADESH,SAHARANPUR,GANGOH,2,147,3,16,1,169
UTTAR PRADESH,SAHARANPUR,MUZAFFARABAD,9,117,59,50,17,252
UTTAR PRADESH,SAHARANPUR,NAGAL,2,71,33,36,2,144
UTTAR PRADESH,SAHARANPUR,NAKUR,7,156,17,16,3,199
UTTAR PRADESH,SAHARANPUR,NANAUTA,4,31,2,13,0,50
UTTAR PRADESH,SAHARANPUR,PUVARKA,11,64,12,33,4,124
UTTAR PRADESH,SAHARANPUR,RAMPUR MANIHARAN,3,23,9,17,0,52
UTTAR PRADESH,SAHARANPUR,SADAULI QADEEM,0,2,2,1,0,5
UTTAR PRADESH,SAHARANPUR,SARSAWAN,0,39,0,6,3,48
UTTAR PRADESH,SANT KABIR NAGAR,BAGHAULEE,15,10,5,5,2,37
UTTAR PRADESH,SANT KABIR NAGAR,BELHAR KALA,1,1,0,0,0,2
UTTAR PRADESH,SANT KABIR NAGAR,HAISAR BAZAR,42,7,1,6,0,56
UTTAR PRADESH,SANT KABIR NAGAR,KHALILABAD,19,7,0,0,0,26
UTTAR PRADESH,SANT KABIR NAGAR,MENHDAWAL,39,14,1,11,0,65
UTTAR PRADESH,SANT KABIR NAGAR,NATHNAGAR,25,18,0,2,0,45
UTTAR PRADESH,SANT KABIR NAGAR,PAULI,0,5,0,0,0,5
UTTAR PRADESH,SANT KABIR NAGAR,SAANTHA,20,111,0,0,1,132
UTTAR PRADESH,SANT KABIR NAGAR,SEMARIYAWAN,11,11,0,8,0,30
UTTAR PRADESH,SANT RAVI DAS NAGAR,ABHOLI,6,0,0,0,0,6
UTTAR PRADESH,SANT RAVI DAS NAGAR,AURAI,13,41,27,49,2,132
UTTAR PRADESH,SANT RAVI DAS NAGAR,BHADOHI,1,8,21,6,0,36
UTTAR PRADESH,SANT RAVI DAS NAGAR,DEEH,4,40,2,6,29,81
UTTAR PRADESH,SANT RAVI DAS NAGAR,GYANPUR,15,77,5,26,12,135
UTTAR PRADESH,SANT RAVI DAS NAGAR,SURIYAWA,1,6,22,21,53,103
UTTAR PRADESH,SHAHJAHANPUR,BANDA,0,29,0,1,0,30
UTTAR PRADESH,SHAHJAHANPUR,BHAAWAL KHERA,0,29,0,5,0,34
UTTAR PRADESH,SHAHJAHANPUR,DADROL,0,55,0,6,16,77
UTTAR PRADESH,SHAHJAHANPUR,JAITIPUR,0,40,0,0,0,40
UTTAR PRADESH,SHAHJAHANPUR,JALALABAD,0,37,0,2,1,40
UTTAR PRADESH,SHAHJAHANPUR,KALAN,0,33,0,6,0,39
UTTAR PRADESH,SHAHJAHANPUR,KANTH,0,35,0,0,0,35
UTTAR PRADESH,SHAHJAHANPUR,KATRA,0,17,9,0,0,26
UTTAR PRADESH,SHAHJAHANPUR,KHUTAR,0,26,0,0,0,26
UTTAR PRADESH,SHAHJAHANPUR,MADNAPUR,0,3,0,0,0,3
UTTAR PRADESH,SHAHJAHANPUR,MIRZAPUR,0,17,0,1,0,18
UTTAR PRADESH,SHAHJAHANPUR,NIGOHI,0,16,0,2,0,18
UTTAR PRADESH,SHAHJAHANPUR,POWAYAN,0,82,0,0,0,82
UTTAR PRADESH,SHAHJAHANPUR,SINDHAULI,1,14,0,0,0,15
UTTAR PRADESH,SHAHJAHANPUR,TILHER,0,8,1,0,0,9
UTTAR PRADESH,SHRAWASTI,GILAULA,10,52,1,0,1,64
UTTAR PRADESH,SHRAWASTI,HARIHAR PUR RANI,0,4,0,0,0,4
UTTAR PRADESH,SHRAWASTI,IKAUNA,20,55,1,0,0,76
UTTAR PRADESH,SHRAWASTI,JAMUNHA,5,83,3,3,1,95
UTTAR PRADESH,SHRAWASTI,SIRSHIYA,0,8,1,0,0,9
UTTAR PRADESH,SIDDHARTH NAGAR,BADHANI,0,6,0,0,0,6
UTTAR PRADESH,SIDDHARTH NAGAR,BANSI,8,11,0,0,1,20
UTTAR PRADESH,SIDDHARTH NAGAR,BHANAWAPUR,1,7,0,0,0,8
UTTAR PRADESH,SIDDHARTH NAGAR,BIRDPUR,0,17,0,0,0,17
UTTAR PRADESH,SIDDHARTH NAGAR,DUMARIYA GANJ,0,32,1,0,1,34
UTTAR PRADESH,SIDDHARTH NAGAR,ITWA,0,10,0,0,1,11
UTTAR PRADESH,SIDDHARTH NAGAR,JOGIYA,0,5,0,0,0,5
UTTAR PRADESH,SIDDHARTH NAGAR,KHESRAHA,0,39,0,0,0,39
UTTAR PRADESH,SIDDHARTH NAGAR,KHUNION,0,8,0,0,0,8
UTTAR PRADESH,SIDDHARTH NAGAR,LOTAN,1,4,1,0,1,7
UTTAR PRADESH,SIDDHARTH NAGAR,MITHWAL,6,26,0,0,0,32
UTTAR PRADESH,SIDDHARTH NAGAR,NAUGHAR,0,14,0,0,0,14
UTTAR PRADESH,SIDDHARTH NAGAR,SHOHRATH GARH,0,1,0,0,0,1
UTTAR PRADESH,SIDDHARTH NAGAR,USKA BAZAR,392,72,16,2,0,482
UTTAR PRADESH,SITAPUR,AILIYA,7,23,0,0,0,30
UTTAR PRADESH,SITAPUR,BEHTA,12,11,0,0,0,23
UTTAR PRADESH,SITAPUR,BESWAN,105,27,0,0,1,133
UTTAR PRADESH,SITAPUR,GODLAMAO,23,43,0,0,1,67
UTTAR PRADESH,SITAPUR,HARGAON,53,32,0,0,0,85
UTTAR PRADESH,SITAPUR,KASMANDA,15,17,0,0,0,32
UTTAR PRADESH,SITAPUR,KHAIRABAD,22,39,0,0,0,61
UTTAR PRADESH,SITAPUR,LAHERPUR,19,11,0,0,0,30
UTTAR PRADESH,SITAPUR,MACHREHTA,20,33,0,0,0,53
UTTAR PRADESH,SITAPUR,MAHMOODABAD,11,21,0,0,0,32
UTTAR PRADESH,SITAPUR,MAHOLI,24,21,0,0,0,45
UTTAR PRADESH,SITAPUR,MISHRIKH,17,24,0,0,0,41
UTTAR PRADESH,SITAPUR,PAHLA,41,112,0,0,0,153
UTTAR PRADESH,SITAPUR,PERSENDI,64,30,0,0,0,94
UTTAR PRADESH,SITAPUR,PISWAN,41,91,0,0,2,134
UTTAR PRADESH,SITAPUR,RAMPUR MATHURA,3,11,0,0,0,14
UTTAR PRADESH,SITAPUR,REUSA,4,13,0,0,0,17
UTTAR PRADESH,SITAPUR,SAKEREN,4,3,0,0,0,7
UTTAR PRADESH,SITAPUR,SIDHAOLI,27,9,0,0,0,36
UTTAR PRADESH,SONBHADRA,CHATRA,0,102,0,0,0,102
UTTAR PRADESH,SONBHADRA,CHOPAN,0,8,0,0,0,8
UTTAR PRADESH,SONBHADRA,LALGANJ,5,2,0,0,0,7
UTTAR PRADESH,SONBHADRA,RABERTSGANJ,195,487,0,1,0,683
UTTAR PRADESH,SULTANPUR,AKHANDNAGAR,28,4,0,2,10,44
UTTAR PRADESH,SULTANPUR,AMETHI,4,0,0,26,1,31
UTTAR PRADESH,SULTANPUR,BALDERAI,17,3,1,14,5,40
UTTAR PRADESH,SULTANPUR,BHADAIYAN,0,14,34,0,1,49
UTTAR PRADESH,SULTANPUR,BHADAR,12,8,2,22,1,45
UTTAR PRADESH,SULTANPUR,BHETUA,8,16,1,23,15,63
UTTAR PRADESH,SULTANPUR,DHANPATGANJ,2,5,6,8,0,21
UTTAR PRADESH,SULTANPUR,DOSTPUR,10,13,39,0,0,62
UTTAR PRADESH,SULTANPUR,DUBEYPUR,18,12,2,6,27,65
UTTAR PRADESH,SULTANPUR,GAURIGANJ,0,2,1,0,1,4
UTTAR PRADESH,SULTANPUR,JAGDISHPUR,9,7,1,15,4,36
UTTAR PRADESH,SULTANPUR,JAISINGHPUR,29,22,25,21,26,123
UTTAR PRADESH,SULTANPUR,JAMON,2,2,2,19,3,28
UTTAR PRADESH,SULTANPUR,KADIPUR,4,21,49,1,26,101
UTTAR PRADESH,SULTANPUR,KUREBHAR,29,40,7,6,9,91
UTTAR PRADESH,SULTANPUR,KURWAR,0,2,2,8,12,24
UTTAR PRADESH,SULTANPUR,LAMBHUA,0,3,31,0,0,34
UTTAR PRADESH,SULTANPUR,MOTIGARPUR,0,3,0,0,0,3
UTTAR PRADESH,SULTANPUR,MUSAFIRKHANA,29,40,2,24,0,95
UTTAR PRADESH,SULTANPUR,PRATAPPUR KAMAINCHA,0,0,6,0,0,6
UTTAR PRADESH,SULTANPUR,SANGRAMPUR,5,5,0,20,1,31
UTTAR PRADESH,SULTANPUR,SHAHGARH,8,4,0,25,1,38
UTTAR PRADESH,SULTANPUR,SHUKUL_BAZAR,4,3,0,6,0,13
UTTAR PRADESH,UNNAO,ASOHA,7,44,0,0,0,51
UTTAR PRADESH,UNNAO,AURAS,0,0,0,1,0,1
UTTAR PRADESH,UNNAO,BANGARMAU,3,22,0,0,1,26
UTTAR PRADESH,UNNAO,BICHHIYA,0,5,0,0,1,6
UTTAR PRADESH,UNNAO,BIGHAPUR,2,1,1,3,2,9
UTTAR PRADESH,UNNAO,FATEHPUR CHAURASI,2,12,1,1,0,16
UTTAR PRADESH,UNNAO,GANJ MORADABAD,3,6,0,0,0,9
UTTAR PRADESH,UNNAO,HASAN GANJ,1,5,1,1,0,8
UTTAR PRADESH,UNNAO,HILAULI,3,9,1,3,0,16
UTTAR PRADESH,UNNAO,NAWABGANJ,0,14,0,1,0,15
UTTAR PRADESH,UNNAO,PURWA,0,1,0,0,0,1
UTTAR PRADESH,UNNAO,SAFIPUR,2,9,0,0,0,11
UTTAR PRADESH,UNNAO,SIKANDARPUR KARAN,3,4,1,1,0,9
UTTAR PRADESH,UNNAO,SIKANDARPUR SARAUSI,4,21,1,2,0,28
UTTAR PRADESH,UNNAO,SUMERPUR,36,10,0,0,0,46
UTTAR PRADESH,VARANASI,AARAJILAINS,121,415,25,20,26,607
UTTAR PRADESH,VARANASI,BADAGOAN,41,62,8,14,18,143
UTTAR PRADESH,VARANASI,CHIRAI GOAN,14,64,8,11,12,109
UTTAR PRADESH,VARANASI,CHOLA PUR,3,25,1,1,2,32
UTTAR PRADESH,VARANASI,HARAHUAA,0,16,4,0,2,22
UTTAR PRADESH,VARANASI,KASHI VIDYAPEETH,293,120,29,14,13,469
UTTAR PRADESH,VARANASI,PINDRA,49,69,6,6,11,141
UTTAR PRADESH,VARANASI,SAVAPURI,11,19,24,41,14,109
UTTARAKHAND,CHAMPAWAT,CHAMPAWAT,3,0,0,0,0,3
UTTARAKHAND,DEHRA DUN,DOIWALA,9,0,1,0,18,28
UTTARAKHAND,DEHRA DUN,RAIPUR,1,2,0,7,7,17
UTTARAKHAND,DEHRA DUN,SEHASPUR,25,10,13,1,29,78
UTTARAKHAND,DEHRA DUN,VIKASH NAGAR,26,10,3,0,28,67
UTTARAKHAND,HARIDWAR,BHADRABAD,45,0,0,0,0,45
UTTARAKHAND,HARIDWAR,BHAGWAN PUR,272,55,12,3,2,344
UTTARAKHAND,HARIDWAR,KHANPUR,17,1,0,1,0,19
UTTARAKHAND,HARIDWAR,LAXUR,2,2,0,0,0,4
UTTARAKHAND,HARIDWAR,NARSAN,1,18,0,0,0,19
UTTARAKHAND,HARIDWAR,ROORKEE,18,56,2,5,1,82
UTTARAKHAND,NAINITAL,HALDWANI,68,2,11,1,16,98
UTTARAKHAND,NAINITAL,KOTABAGH,4,2,11,4,2,23
UTTARAKHAND,NAINITAL,RAMNAGAR,4,1,61,47,1,114
UTTARAKHAND,UDHAM SINGH NAGAR,BAZPUR,24,1,0,13,0,38
UTTARAKHAND,UDHAM SINGH NAGAR,GADARPUR,13,0,0,11,0,24
UTTARAKHAND,UDHAM SINGH NAGAR,JASPUR,27,1,0,0,0,28
UTTARAKHAND,UDHAM SINGH NAGAR,KASHIPUR,13,0,1,12,0,26
UTTARAKHAND,UDHAM SINGH NAGAR,KHATIMA,90,2,1,9,0,102
UTTARAKHAND,UDHAM SINGH NAGAR,RUDRAPUR,29,0,0,7,0,36
UTTARAKHAND,UDHAM SINGH NAGAR,SITARGANJ,135,0,0,0,0,135
WEST BENGAL,BANKURA,BANKURA-I,0,1,0,0,0,1
WEST BENGAL,BANKURA,BISHNUPUR,0,22,7,2,0,31
WEST BENGAL,BANKURA,BORJORA,0,6,1,0,0,7
WEST BENGAL,BANKURA,INDUS,0,9,3,0,0,12
WEST BENGAL,BANKURA,JOYPUR,0,13,2,1,0,16
WEST BENGAL,BANKURA,KATUL PUR,0,15,9,7,0,31
WEST BENGAL,BANKURA,ONDA,0,5,1,0,0,6
WEST BENGAL,BANKURA,PATRASAYER,5,13,6,3,0,27
WEST BENGAL,BANKURA,SIMLAPAL,0,1,0,0,0,1
WEST BENGAL,BANKURA,SONAMUKHI,0,24,4,1,0,29
WEST BENGAL,BANKURA,TALDANGRA,0,7,0,0,0,7
WEST BENGAL,BARDDHAMAN,AUSGRAM-I,1,4,0,0,0,5
WEST BENGAL,BARDDHAMAN,AUSGRAM-II,1,7,0,0,0,8
WEST BENGAL,BARDDHAMAN,BHATAR,2,1,0,0,0,3
WEST BENGAL,BARDDHAMAN,BURDWAN-1,4,10,1,0,0,15
WEST BENGAL,BARDDHAMAN,BURDWAN-2,0,4,1,0,0,5
WEST BENGAL,BARDDHAMAN,GALSI-1,0,4,4,0,0,8
WEST BENGAL,BARDDHAMAN,GALSI-2,0,4,0,0,0,4
WEST BENGAL,BARDDHAMAN,JAMALPUR,1,16,7,2,0,26
WEST BENGAL,BARDDHAMAN,KALNA-1,4,20,16,3,0,43
WEST BENGAL,BARDDHAMAN,KALNA-2,10,20,18,0,0,48
WEST BENGAL,BARDDHAMAN,KANKSHA,1,4,1,0,0,6
WEST BENGAL,BARDDHAMAN,KATUGRAM-I,7,7,0,0,0,14
WEST BENGAL,BARDDHAMAN,KATUGRAM-II,11,16,2,0,0,29
WEST BENGAL,BARDDHAMAN,KATWA-I,12,25,0,0,0,37
WEST BENGAL,BARDDHAMAN,KATWA-II,15,33,7,0,0,55
WEST BENGAL,BARDDHAMAN,KHANDAGHOSH,12,16,2,0,0,30
WEST BENGAL,BARDDHAMAN,MANGALCOTE,3,9,1,0,0,13
WEST BENGAL,BARDDHAMAN,MEMARI-2,2,19,7,1,0,29
WEST BENGAL,BARDDHAMAN,MEMARI(1),2,6,3,0,0,11
WEST BENGAL,BARDDHAMAN,MONTESWAR,7,32,13,0,0,52
WEST BENGAL,BARDDHAMAN,PURBASTHALI-1,9,40,12,0,0,61
WEST BENGAL,BARDDHAMAN,PURBASTHALI-2,2,55,10,0,0,67
WEST BENGAL,BARDDHAMAN,RAINA-1,9,30,11,0,0,50
WEST BENGAL,BARDDHAMAN,RAINA-2,0,25,11,0,0,36
WEST BENGAL,BIRBHUM,BOLPUR SRINEKATAN,3,3,0,0,0,6
WEST BENGAL,BIRBHUM,DUBRAJ PUR,6,19,3,0,0,28
WEST BENGAL,BIRBHUM,ILLAM BAZAR,8,20,26,0,0,54
WEST BENGAL,BIRBHUM,MAYURESWAR-1,3,6,0,0,0,9
WEST BENGAL,BIRBHUM,MAYUURESWAR-2,0,3,0,0,0,3
WEST BENGAL,BIRBHUM,MURARAI-1,0,2,0,0,0,2
WEST BENGAL,BIRBHUM,MURARAI-2,0,16,0,0,0,16
WEST BENGAL,BIRBHUM,NALHATI-1,0,6,0,0,0,6
WEST BENGAL,BIRBHUM,NALHATI-2,1,7,0,0,0,8
WEST BENGAL,BIRBHUM,RAMPURHAT-I,0,2,0,0,0,2
WEST BENGAL,BIRBHUM,RAMPURHAT-II,0,1,0,0,0,1
WEST BENGAL,BIRBHUM,SAINTHIA,1,0,0,0,0,1
WEST BENGAL,DAKSHIN DINAJPUR,BALURGHAT,31,18,0,0,0,49
WEST BENGAL,DAKSHIN DINAJPUR,BANSIHARI,0,5,1,0,0,6
WEST BENGAL,DAKSHIN DINAJPUR,GANGARAMPUR,2,4,0,0,0,6
WEST BENGAL,DAKSHIN DINAJPUR,HARIRAMPUR,0,7,1,0,0,8
WEST BENGAL,DAKSHIN DINAJPUR,HILI,1,20,1,0,0,22
WEST BENGAL,DAKSHIN DINAJPUR,KUMARGANJ,13,9,1,0,0,23
WEST BENGAL,DAKSHIN DINAJPUR,KUSHMANDI,0,20,17,0,0,37
WEST BENGAL,DAKSHIN DINAJPUR,TAPAN,0,3,0,0,0,3
WEST BENGAL,DARJEELING,KHARIBARI,1,0,0,0,0,1
WEST BENGAL,DARJEELING,MATIGARA,1,0,0,0,0,1
WEST BENGAL,DARJEELING,PHANSIDEWA,0,2,0,0,0,2
WEST BENGAL,HAORA,AMTA-I,0,35,3,0,0,38
WEST BENGAL,HAORA,AMTA-II,0,16,8,0,0,24
WEST BENGAL,HAORA,BAGNAN-I,0,19,2,0,0,21
WEST BENGAL,HAORA,BAGNAN-II,1,16,0,0,0,17
WEST BENGAL,HAORA,BALLYJAGACHA,0,1,0,0,0,1
WEST BENGAL,HAORA,DOMJUR,0,12,0,0,0,12
WEST BENGAL,HAORA,JAGOTBALLAVPUR,1,34,0,1,0,36
WEST BENGAL,HAORA,PANCHLA,0,8,0,0,0,8
WEST BENGAL,HAORA,SHYAMPUR-II,0,1,0,0,0,1
WEST BENGAL,HAORA,UDAY NARAYANPUR,1,51,9,0,0,61
WEST BENGAL,HAORA,ULUBERIA-II,0,1,0,0,0,1
WEST BENGAL,HOOGHLY,ARAMBAGH,23,25,9,1,2,60
WEST BENGAL,HOOGHLY,BALAGARH,0,14,30,13,0,57
WEST BENGAL,HOOGHLY,CHANDITALA-I,0,1,4,15,0,20
WEST BENGAL,HOOGHLY,CHANDITALA-II,0,0,10,1,3,14
WEST BENGAL,HOOGHLY,CHINSURAH-MOGRA,3,2,3,18,3,29
WEST BENGAL,HOOGHLY,DHANIAKHALI,0,2,5,8,12,27
WEST BENGAL,HOOGHLY,GOGHAT-I,11,4,0,0,1,16
WEST BENGAL,HOOGHLY,GOGHAT-II,0,6,6,4,0,16
WEST BENGAL,HOOGHLY,HARIPAL,0,1,8,9,5,23
WEST BENGAL,HOOGHLY,JANGIPARA,0,0,2,17,5,24
WEST BENGAL,HOOGHLY,KHANAKUL-I,3,0,10,15,2,30
WEST BENGAL,HOOGHLY,KHANAKUL-II,2,5,1,12,0,20
WEST BENGAL,HOOGHLY,PANDUA,1,3,19,47,9,79
WEST BENGAL,HOOGHLY,POLBA DADPUR,10,0,26,11,6,53
WEST BENGAL,HOOGHLY,PURSURAH,8,3,9,5,4,29
WEST BENGAL,HOOGHLY,SERAMPUR-UTTERPARA,0,0,7,6,0,13
WEST BENGAL,HOOGHLY,SINGUR,1,2,8,10,4,25
WEST BENGAL,HOOGHLY,TARAKESWAR,0,0,4,11,2,17
WEST BENGAL,JALPAIGURI,ALIPURDUAR-1,0,0,4,0,0,4
WEST BENGAL,JALPAIGURI,ALIPURDUAR-2,0,0,5,0,0,5
WEST BENGAL,JALPAIGURI,DHUPGURI,16,14,1,1,0,32
WEST BENGAL,JALPAIGURI,FALAKATA,0,4,9,0,0,13
WEST BENGAL,JALPAIGURI,JALPAIGURI SADAR,9,3,8,0,0,20
WEST BENGAL,JALPAIGURI,KALCHINI,20,9,2,0,0,31
WEST BENGAL,JALPAIGURI,KUMARGRAM,6,3,3,1,0,13
WEST BENGAL,JALPAIGURI,MADARIHAT,4,2,5,5,0,16
WEST BENGAL,JALPAIGURI,MAL,12,8,7,0,0,27
WEST BENGAL,JALPAIGURI,MATIALI,0,2,0,0,0,2
WEST BENGAL,JALPAIGURI,MAYNAGURI,4,3,6,0,0,13
WEST BENGAL,JALPAIGURI,NAGRAKATA,0,3,0,0,0,3
WEST BENGAL,JALPAIGURI,RAJGANJ,2,2,1,0,0,5
WEST BENGAL,KOCH BEHAR,COOCHBEHAR-I,2,2,11,0,0,15
WEST BENGAL,KOCH BEHAR,COOCHBEHAR-II,0,2,5,0,0,7
WEST BENGAL,KOCH BEHAR,DINHATA-1,0,7,14,0,0,21
WEST BENGAL,KOCH BEHAR,DINHATA-II,4,2,3,0,0,9
WEST BENGAL,KOCH BEHAR,HALDIBARI,0,0,2,0,0,2
WEST BENGAL,KOCH BEHAR,MATHABHANGA-I,0,1,1,0,0,2
WEST BENGAL,KOCH BEHAR,MEKHLIGANJ,0,1,1,0,0,2
WEST BENGAL,KOCH BEHAR,SITAI,0,1,1,0,0,2
WEST BENGAL,KOCH BEHAR,SITALKUCHI,1,1,2,0,0,4
WEST BENGAL,KOCH BEHAR,TUFANGANJ-I,1,1,3,0,0,5
WEST BENGAL,KOCH BEHAR,TUFANGANJ-II,1,3,5,0,0,9
WEST BENGAL,MALDA,CHANCHAL-I,0,23,5,0,0,28
WEST BENGAL,MALDA,CHANCHAL-II,1,23,13,0,0,37
WEST BENGAL,MALDA,ENGLISH BAZAR,16,34,0,0,0,50
WEST BENGAL,MALDA,GAZOLE,0,23,0,0,0,23
WEST BENGAL,MALDA,HABIBPUR,0,1,0,0,0,1
WEST BENGAL,MALDA,HARISHCHANDRAPUR-I,1,9,1,0,0,11
WEST BENGAL,MALDA,HARISHCHANDRAPUR-II,0,9,2,0,0,11
WEST BENGAL,MALDA,KALIACHAK-I,0,14,1,0,0,15
WEST BENGAL,MALDA,KALIACHAK-II,0,26,0,0,0,26
WEST BENGAL,MALDA,KALIACHAK-III,5,31,1,0,0,37
WEST BENGAL,MALDA,MANIKCHAK,2,19,0,0,0,21
WEST BENGAL,MALDA,OLD MALDA,1,53,2,0,0,56
WEST BENGAL,MALDA,RATUA-I,1,28,4,0,0,33
WEST BENGAL,MALDA,RATUA-II,1,25,2,0,0,28
WEST BENGAL,MURSHIDABAD,BELDANGA-I,0,6,0,0,0,6
WEST BENGAL,MURSHIDABAD,BELDANGA-II,2,6,1,0,0,9
WEST BENGAL,MURSHIDABAD,BERHAMPORE,7,54,2,0,0,63
WEST BENGAL,MURSHIDABAD,BHAGWANGOLA-I,5,15,0,0,0,20
WEST BENGAL,MURSHIDABAD,BHAGWANGOLA-II,3,14,1,0,0,18
WEST BENGAL,MURSHIDABAD,BHARATPUR-I,1,6,1,0,0,8
WEST BENGAL,MURSHIDABAD,BHARATPUR-II,2,14,0,0,0,16
WEST BENGAL,MURSHIDABAD,BURWAN,7,6,0,0,0,13
WEST BENGAL,MURSHIDABAD,DOMKAL,12,35,9,1,0,57
WEST BENGAL,MURSHIDABAD,HARIHARPARA,2,41,7,0,0,50
WEST BENGAL,MURSHIDABAD,JALANGI,4,48,1,0,0,53
WEST BENGAL,MURSHIDABAD,KANDI,2,18,0,0,0,20
WEST BENGAL,MURSHIDABAD,KHARGRAM,1,24,0,0,0,25
WEST BENGAL,MURSHIDABAD,LALGOLA,21,28,0,0,0,49
WEST BENGAL,MURSHIDABAD,MURSHIDABAD-JIAGANJ,5,29,0,0,0,34
WEST BENGAL,MURSHIDABAD,NABAGRAM,21,26,0,0,0,47
WEST BENGAL,MURSHIDABAD,NOWDA,8,25,1,0,0,34
WEST BENGAL,MURSHIDABAD,RAGHUNATH GANJE-I,4,1,0,0,0,5
WEST BENGAL,MURSHIDABAD,RANINAGAR-I,3,23,0,0,0,26
WEST BENGAL,MURSHIDABAD,RANINAGAR-II,3,28,0,0,0,31
WEST BENGAL,MURSHIDABAD,SAGARDIGHI,9,13,0,0,0,22
WEST BENGAL,MURSHIDABAD,SAMSHERGANJ,1,6,0,0,0,7
WEST BENGAL,MURSHIDABAD,SUTI-I,1,3,0,0,0,4
WEST BENGAL,MURSHIDABAD,SUTI-II,0,12,3,0,0,15
WEST BENGAL,NADIA,CHAKDAH,14,29,22,2,0,67
WEST BENGAL,NADIA,CHAPRA,9,31,1,1,0,42
WEST BENGAL,NADIA,HANSKHALI,0,36,37,1,0,74
WEST BENGAL,NADIA,HARINGHATA,3,11,12,15,0,41
WEST BENGAL,NADIA,KALIGANJ,19,20,0,0,0,39
WEST BENGAL,NADIA,KARIMPUR-I,4,32,6,0,0,42
WEST BENGAL,NADIA,KARIMPUR-II,1,30,11,0,0,42
WEST BENGAL,NADIA,KRISHNAGANJ,2,15,6,3,0,26
WEST BENGAL,NADIA,KRISHNANAGAR-I,3,50,30,1,0,84
WEST BENGAL,NADIA,KRISHNANAGAR-II,13,3,9,0,0,25
WEST BENGAL,NADIA,NABADWIP,2,10,6,0,0,18
WEST BENGAL,NADIA,NAKASHIPARA,10,36,4,0,0,50
WEST BENGAL,NADIA,RANAGHAT-I,8,26,8,0,0,42
WEST BENGAL,NADIA,RANAGHAT-II,8,23,46,2,0,79
WEST BENGAL,NADIA,SANTIPUR,6,14,36,8,0,64
WEST BENGAL,NADIA,TEHATTA-I,9,23,5,0,0,37
WEST BENGAL,NADIA,TEHATTA-II,0,21,0,0,0,21
WEST BENGAL,NORTH  PARGANAS,AMDANGA,9,4,2,13,0,28
WEST BENGAL,NORTH  PARGANAS,BADURIA,1,33,1,1,0,36
WEST BENGAL,NORTH  PARGANAS,BAGDAH,2,20,3,1,0,26
WEST BENGAL,NORTH  PARGANAS,BARASAT-I,3,8,3,7,0,21
WEST BENGAL,NORTH  PARGANAS,BARASAT-II,4,13,2,7,0,26
WEST BENGAL,NORTH  PARGANAS,BARRACKPORE-I,2,9,4,20,0,35
WEST BENGAL,NORTH  PARGANAS,BARRACKPORE-II,1,9,1,2,0,13
WEST BENGAL,NORTH  PARGANAS,BASIRHAT-(I),0,3,0,0,0,3
WEST BENGAL,NORTH  PARGANAS,BASIRHAT II,1,4,1,0,0,6
WEST BENGAL,NORTH  PARGANAS,BONGAON,1,33,4,1,0,39
WEST BENGAL,NORTH  PARGANAS,DEYGANGA,0,7,1,1,0,9
WEST BENGAL,NORTH  PARGANAS,GAIGHATA,8,13,0,4,0,25
WEST BENGAL,NORTH  PARGANAS,HABRA-I,7,12,1,19,0,39
WEST BENGAL,NORTH  PARGANAS,HABRA-II,1,13,4,26,0,44
WEST BENGAL,NORTH  PARGANAS,HAROA,1,5,0,0,0,6
WEST BENGAL,NORTH  PARGANAS,RAJARHAT,0,7,0,2,0,9
WEST BENGAL,NORTH  PARGANAS,SANDESHKALI-II,0,0,2,0,0,2
WEST BENGAL,NORTH  PARGANAS,SWARUP NAGAR,2,7,4,1,0,14
WEST BENGAL,PASHCHIM MIDNAPORE,BINPUR - I,0,2,0,0,0,2
WEST BENGAL,PASHCHIM MIDNAPORE,BINPUR - II,0,0,1,0,0,1
WEST BENGAL,PASHCHIM MIDNAPORE,CHANDRAKONA - 2,0,7,2,3,0,12
WEST BENGAL,PASHCHIM MIDNAPORE,CHANDRAKONA - I,6,6,1,1,0,14
WEST BENGAL,PASHCHIM MIDNAPORE,DANTAN - II,0,8,1,3,0,12
WEST BENGAL,PASHCHIM MIDNAPORE,DANTON - I,0,12,10,1,0,23
WEST BENGAL,PASHCHIM MIDNAPORE,DASPUR - I,1,13,2,1,0,17
WEST BENGAL,PASHCHIM MIDNAPORE,DASPUR - II,0,6,4,2,0,12
WEST BENGAL,PASHCHIM MIDNAPORE,DEBRA,0,11,22,6,0,39
WEST BENGAL,PASHCHIM MIDNAPORE,GARHBETA - I,3,7,6,1,0,17
WEST BENGAL,PASHCHIM MIDNAPORE,GARHBETA - II,0,6,4,0,0,10
WEST BENGAL,PASHCHIM MIDNAPORE,GARHBETA - III,0,5,4,0,0,9
WEST BENGAL,PASHCHIM MIDNAPORE,GHATAL,2,23,7,0,0,32
WEST BENGAL,PASHCHIM MIDNAPORE,GOPIBALLAVPUR - II,0,2,2,0,0,4
WEST BENGAL,PASHCHIM MIDNAPORE,JAMBANI,0,2,1,0,0,3
WEST BENGAL,PASHCHIM MIDNAPORE,JHARGRAM,0,8,0,1,0,9
WEST BENGAL,PASHCHIM MIDNAPORE,KESHIARY,1,8,0,0,0,9
WEST BENGAL,PASHCHIM MIDNAPORE,KESHPUR,4,46,17,0,0,67
WEST BENGAL,PASHCHIM MIDNAPORE,KHARAGPUR - I,2,5,1,0,0,8
WEST BENGAL,PASHCHIM MIDNAPORE,KHARAGPUR - II,0,4,1,1,0,6
WEST BENGAL,PASHCHIM MIDNAPORE,MIDNAPORE SADAR,1,4,4,0,0,9
WEST BENGAL,PASHCHIM MIDNAPORE,MOHANPUR,0,4,12,0,0,16
WEST BENGAL,PASHCHIM MIDNAPORE,NARAYANGARH,5,21,4,1,0,31
WEST BENGAL,PASHCHIM MIDNAPORE,PINGLA,0,19,2,0,0,21
WEST BENGAL,PASHCHIM MIDNAPORE,SABANG,0,10,6,0,0,16
WEST BENGAL,PASHCHIM MIDNAPORE,SALBONI,0,0,4,0,0,4
WEST BENGAL,PASHCHIM MIDNAPORE,SANKRAIL,0,3,1,0,0,4
WEST BENGAL,PURBA MIDNAPORE,BHAGWANPUR - I,0,11,2,0,0,13
WEST BENGAL,PURBA MIDNAPORE,BHAGWANPUR - II,0,2,2,1,0,5
WEST BENGAL,PURBA MIDNAPORE,CONTAI - III,0,1,0,0,0,1
WEST BENGAL,PURBA MIDNAPORE,EGRA - I,2,12,2,2,0,18
WEST BENGAL,PURBA MIDNAPORE,EGRA - II,0,7,5,1,0,13
WEST BENGAL,PURBA MIDNAPORE,KOLAGHAT,0,16,0,1,0,17
WEST BENGAL,PURBA MIDNAPORE,MAHISHADAL,0,7,0,0,0,7
WEST BENGAL,PURBA MIDNAPORE,MOYNA,0,7,0,0,0,7
WEST BENGAL,PURBA MIDNAPORE,NANDAKUMAR,0,4,0,0,0,4
WEST BENGAL,PURBA MIDNAPORE,PANSKURA - I,0,27,1,0,0,28
WEST BENGAL,PURBA MIDNAPORE,PATASHPUR - I,0,11,1,1,0,13
WEST BENGAL,PURBA MIDNAPORE,PATASHPUR - II,2,13,1,0,0,16
WEST BENGAL,PURBA MIDNAPORE,RAMNAGAR - I,0,2,0,0,0,2
WEST BENGAL,PURBA MIDNAPORE,RAMNAGAR - II,0,2,0,0,0,2
WEST BENGAL,PURBA MIDNAPORE,SAHID MATANGINI,0,16,0,0,0,16
WEST BENGAL,PURBA MIDNAPORE,SUTAHATA,0,2,0,0,0,2
WEST BENGAL,PURBA MIDNAPORE,TAMLUK,0,13,7,3,0,23
WEST BENGAL,SOUTH  PARGANAS,BARUIPUR,0,0,0,0,13,13
WEST BENGAL,SOUTH  PARGANAS,BHANGORE-I,0,0,0,0,3,3
WEST BENGAL,SOUTH  PARGANAS,BHANGORE-II,0,0,0,0,2,2
WEST BENGAL,SOUTH  PARGANAS,BISHNUPUR-I,0,0,0,0,1,1
WEST BENGAL,SOUTH  PARGANAS,BISHNUPUR-II,0,0,0,0,6,6
WEST BENGAL,SOUTH  PARGANAS,BUDGE BUDGE-II,0,0,0,0,5,5
WEST BENGAL,SOUTH  PARGANAS,CANNING-I,0,0,0,0,1,1
WEST BENGAL,SOUTH  PARGANAS,CANNING-II,0,0,0,0,1,1
WEST BENGAL,SOUTH  PARGANAS,DIAMOND HARBOUR-I,0,0,0,0,3,3
WEST BENGAL,SOUTH  PARGANAS,DIAMOND HARBOUR-II,0,0,0,0,1,1
WEST BENGAL,SOUTH  PARGANAS,FALTA,0,0,0,0,6,6
WEST BENGAL,SOUTH  PARGANAS,JAYNAGAR-I,0,0,0,0,4,4
WEST BENGAL,SOUTH  PARGANAS,JAYNAGAR-II,0,0,0,0,2,2
WEST BENGAL,SOUTH  PARGANAS,KULPI,0,0,0,0,3,3
WEST BENGAL,SOUTH  PARGANAS,MAGRAHAT-I,0,0,0,0,1,1
WEST BENGAL,SOUTH  PARGANAS,MAGRAHAT-II,0,0,0,0,2,2
WEST BENGAL,SOUTH  PARGANAS,MANDIR BAZAR,0,0,0,0,3,3
WEST BENGAL,SOUTH  PARGANAS,MATHURAPUR-I,0,0,0,0,8,8
WEST BENGAL,SOUTH  PARGANAS,MATHURAPUR-II,0,0,0,0,1,1
WEST BENGAL,SOUTH  PARGANAS,NAMKHANA,0,0,0,0,1,1
WEST BENGAL,SOUTH  PARGANAS,SONARPUR,0,1,0,0,3,4
WEST BENGAL,UTTAR DINAJPUR,CHOPRA,0,4,0,0,0,4
WEST BENGAL,UTTAR DINAJPUR,GOALPOKHER-I,2,15,4,0,0,21
WEST BENGAL,UTTAR DINAJPUR,GOALPOKHER-II,2,12,0,0,0,14
WEST BENGAL,UTTAR DINAJPUR,HEMTABAD,3,19,1,0,0,23
WEST BENGAL,UTTAR DINAJPUR,ISLAMPUR,9,11,1,0,0,21
WEST BENGAL,UTTAR DINAJPUR,ITAHAR,1,17,7,0,0,25
WEST BENGAL,UTTAR DINAJPUR,KALIYAGANJ,1,19,4,0,0,24
WEST BENGAL,UTTAR DINAJPUR,KARANDIGHI,4,14,9,1,0,28
WEST BENGAL,UTTAR DINAJPUR,RAIGANJ,8,26,3,0,0,37
